ଅଇନାଟିଏ	/ɔinaːʈie/
ଅଂକା	/ɔŋkaː/
ଅକାଶରେ	/ɔkaːsɔre/
ଅକ୍ଟୋବର	/ɵkʈobɵɾɵ/
ଅକ୍ଷୟ	/ɵkʰjɵjɵ/
ଅକ୍ଷର	/ɵkʰjɵɾɵ/
ଅଗ	/ɔɡɔ/
ଅଗଣାକୁ	/ɔɡɔɳaːku/
ଅଗଷ୍ଟ	/ɵɡɵsʈɵ/
ଅଗ୍ନି	/ɵgni/
ଅଙ୍କ	/ɔŋkɔ/
ଅଙ୍କାବଙ୍କା	/ɔŋkaːbɔŋkaː/
ଅଙ୍ଗ	/ɵŋɡɵ/
ଅଙ୍ଗରକ୍ଷକ	/ɔŋɡɔɾɔkʰjɔkɔ/
ଅଙ୍ଗରକ୍ଷା	/ɔŋɡɔɾɔkʰjaː/
ଅଂଚଳରେ	/ɔŋt͡ʃɔl̪ɔre/
ଅଛନ୍ତି	/ɵt͡ʃʰɵnt̪i/
ଅଛା	/ɔt͡ʃʰaː/
ଅଛି	/ɵt͡ʃʰi/
ଅଛୁ	/ɔt͡ʃʰu/
ଅଜଗର	/ɔd͡ʒɔɡɔɾɔ/
ଅଜଣା	/ɔd͡ʒɔɳaː/
ଅଜବ	/ɔd͡ʒɔbɔ/
ଅଜା	/ɔd͡ʒaː/
ଅଜାଂକୁ	/ɔd͡ʒaːŋku/
ଅଜିତ	/ɵd͡ʒit̪ɵ/
ଅଜ୍ଞାତ	/ɵd͡ʒɲaːt̪ɵ/
ଅଞ୍ଚଳ	/ɵɲt͡ʃɵl̪ɵ/
ଅଞ୍ଚଳର	/ɵɲt͡ʃɵl̪ɵɾɵ/
ଅଞ୍ଚଳରେ	/ɵɲt͡ʃɵl̪ɵre/
ଅଟକି	/ɔʈɔki/
ଅଟକିଗଲେ	/ɔʈɔkiɡɔle/
ଅଟକେଇ	/ɔʈɔkei/
ଅଟନ୍ତି	/ɵʈɵnt̪i/
ଅଟଳ	/ɔʈɔl̪ɔ/
ଅଟା	/ɔʈaː/
ଅଟୁ	/ɔʈu/
ଅଟେ	/ɵʈe/
ଅଟୋରିକ୍ସା	/ɔʈoriksaː/
ଅଣ	/ɵɳɵ/
ଅଣନିଃଶ୍ୱାସୀ	/ɔɳɔnihsuaːsi/
ଅଣସର	/ɵɳɵsɵɾɵ/
ଅଣ୍ଟାରେ	/ɔɳʈaːre/
ଅଣ୍ଟିରେ	/ɔɳʈire/
ଅଣ୍ଡା	/ɵɳɖaː/
ଅତି	/ɵt̪i/
ଅତିକ୍ରମ	/ɔt̪ikɾɔmɔ/
ଅତିଥିଙ୍କ	/ɔt̪it̪ʰiŋkɔ/
ଅତିଥିଙ୍କୁ	/ɔt̪it̪ʰiŋku/
ଅତିରିକ୍ତ	/ɔt̪irikt̪ɔ/
ଅତ୍ୟଧିକ	/ɵt̪jɵd̪ʱikɵ/
ଅତ୍ୟନ୍ତ	/ɵt̪jɵnt̪ɵ/
ଅଥବା	/ɵt̪ʰɵbaː/
ଅଦା	/ɵd̪aː/
ଅଦୃଶ୍ୟ	/ɔd̪rusjɔ/
ଅଦ୍ଭୁତ	/ɔd̪bʱut̪ɔ/
ଅଦ୍ୱିତୀୟ	/ɔd̪uit̪ijɔ/
ଅଧା	/ɔd̪ʱaː/
ଅଧାଇଞ୍ଚ	/ɔd̪ʱaːiɲt͡ʃɔ/
ଅଧାକିଲୋ	/ɔd̪ʱaːkilo/
ଅଧାଖିଆ	/ɔd̪ʱaːkʰiaː/
ଅଧାଗଢା	/ɵd̪ʱaːɡɵɖʱaː/
ଅଧାଗଢ଼ା	/ɵd̪ʱaːɡɵɽʱaː/
ଅଧାରନ୍ଧା	/ɔd̪ʱaːɾɔnd̪ʱaː/
ଅଧିକ	/ɵd̪ʱikɵ/
ଅଧିକା	/ɔd̪ʱikaː/
ଅଧିକାର	/ɵd̪ʱikaːɾɵ/
ଅଧିକାରୀ	/ɵd̪ʱikaːri/
ଅଧିକାଂଶ	/ɵd̪ʱikaːŋsɵ/
ଅଧୀନରେ	/ɵd̪ʱinɵre/
ଅଧୀର	/ɔd̪ʱiɾɔ/
ଅଧୁନା	/ɵd̪ʱunaː/
ଅଧେ	/ɔd̪ʱe/
ଅଧ୍ୟକ୍ଷ	/ɵd̪ʱjɵkʰjɵ/
ଅଧ୍ୟୟନ	/ɵd̪ʱjɵjɵnɵ/
ଅଧ୍ୟାପକ	/ɵd̪ʱjaːpɵkɵ/
ଅନତି	/ɵnɵt̪i/
ଅନନ୍ତ	/ɵnɵnt̪ɵ/
ଅନଲାଇନ	/ɵnɵlaːinɵ/
ଅନାଇଲା	/ɔnaːilaː/
ଅନିତା	/ɵnit̪aː/
ଅନିଲ	/ɔnilɔ/
ଅନିଷ୍ଟ	/ɔnisʈɔ/
ଅନୁ	/ɔnu/
ଅନୁକୁ	/ɔnuku/
ଅନୁଗାମୀ	/ɔnugaːmi/
ଅନୁଗୋଳ	/ɵnugol̪ɵ/
ଅନୁବାଦ	/ɵnubaːd̪ɵ/
ଅନୁଭବ	/ɵnubʰɵbɵ/
ଅନୁମାନ	/ɵnumaːnɵ/
ଅନୁଯାଇ	/ɔnud͡ʒaːi/
ଅନୁଯାୟୀ	/ɵnud͡ʒaːji/
ଅନୁରୋଧ	/ɵnurod̪ʱɵ/
ଅନୁଶରଣ	/ɔnusɔɾɔɳɔ/
ଅନୁଷ୍ଠାନ	/ɵnusʈʰaːnɵ/
ଅନୁଷ୍ଠିତ	/ɵnusʈʰit̪ɵ/
ଅନୁସନ୍ଧାନ	/ɵnusɵnd̪ʱaːnɵ/
ଅନୁସରଣ	/ɔnusɔɾɔɳɔ/
ଅନୁସାରେ	/ɵnusaːre/
ଅନୁସୂଚିତ	/ɵnusut͡ʃit̪ɵ/
ଅନୂସୁଚିତ	/ɵnusut͡ʃit̪ɵ/
ଅନେଇଲେ	/ɔneile/
ଅନେକ	/ɵnekɵ/
ଅନେକାନେକ	/ɔnekaːnekɔ/
ଅନ୍ତ	/ɔnt̪ɔ/
ଅନ୍ତତଃ	/ɔnt̪ɔt̪ɔh/
ଅନ୍ତର୍ଗତ	/ɵnt̪ɵrɡɵt̪ɵ/
ଅନ୍ତର୍ଭୁକ୍ତ	/ɵnt̪ɵrbʱukt̪ɵ/
ଅନ୍ଧକାର	/ɔnd̪ʱɔkaːɾɔ/
ଅନ୍ଧକାରରେ	/ɔnd̪ʱɔkaːɾɔre/
ଅନ୍ଧାର	/ɔnd̪ʱaːɾɔ/
ଅନ୍ୟ	/ɵnjɵ/
ଅନ୍ୟଟି	/ɔnjɔʈi/
ଅନ୍ୟତମ	/ɵnjɵt̪ɵmɵ/
ଅନ୍ୟମାନଂକୁ	/ɔnjɔmaːnɔŋku/
ଅନ୍ୟମାନଙ୍କୁ	/ɔnjɔmaːnɔŋku/
ଅନ୍ୟାନ୍ୟ	/ɵnjaːnjɵ/
ଅପରାଜିତା	/ɵpɵraːd͡ʒit̪aː/
ଅପରାହ୍ନରେ	/ɔpɔraːhnɔre/
ଅପରେଶନ	/ɵpɵresɵnɵ/
ଅପଲକ	/ɔpɔlɔkɔ/
ଅପା	/ɔpaː/
ଅପାଂକ	/ɔpaːŋkɔ/
ଅପାଂକୁ	/ɔpaːŋku/
ଅପେକ୍ଷା	/ɵpekʰjaː/
ଅପ୍ପା	/ɔppaː/
ଅପ୍ପା-ଇମ୍ମା	/ɔppaː-immaː/
ଅପ୍ପା-ଇମ୍ମାଙ୍କ	/ɔppaː-immaːŋkɔ/
ଅପ୍ପାଙ୍କ	/ɔppaːŋkɔ/
ଅପ୍ରେଲ	/ɵprelɵ/
ଅଫ	/ɵpʰɵ/
ଅଫିସ	/ɔpʰisɔ/
ଅଫିସ୍	/ɔpʰis/
ଅଫ୍	/ɵpʰ/
ଅବକାଶ	/ɵbɵkaːsɵ/
ଅବତାର	/ɵbɵt̪aːɾɵ/
ଅବଦାନ	/ɵbɵd̪aːnɵ/
ଅବଦୁଲ୍	/ɔbɔd̪ul/
ଅବନ୍ତୀ	/ɔbɔnt̪i/
ଅବନ୍ତୀକୁ	/ɔbɔnt̪iku/
ଅବନ୍ତୀର	/ɔbɔnt̪iɾɔ/
ଅବରୁଦ୍ଧ	/ɔbɔrud̪d̪ʱɔ/
ଅବର୍ଜନା	/ɔbɔrd͡ʒɔnaː/
ଅବଶେଷ	/ɵbɵsesɵ/
ଅବଶ୍ୟ	/ɔbɔsjɔ/
ଅବସର	/ɵbɵsɵɾɵ/
ଅବସରରେ	/ɵbɵsɵɾɵre/
ଅବସ୍ଥା	/ɵbɵst̪ʰaː/
ଅବସ୍ଥାନ	/ɵbɵst̪ʰaːnɵ/
ଅବସ୍ଥାରେ	/ɵbɵst̪ʰaːre/
ଅବସ୍ଥିତ	/ɵbɵst̪ʰit̪ɵ/
ଅବସ୍ଥିତି	/ɵbɵst̪ʰit̪i/
ଅବା	/ɔbaː/
ଅବାଗିଆ	/ɔbaːgiaː/
ଅବୋଧ	/ɔbod̪ʱɔ/
ଅଭାବ	/ɵbʱaːbɵ/
ଅଭିନୟ	/ɵbʱinɵjɵ/
ଅଭିନୟରେ	/ɵbʱinɵjɵre/
ଅଭିନୀତ	/ɵbʱinit̪ɵ/
ଅଭିନେତା	/ɵbʱinet̪aː/
ଅଭିନେତ୍ରୀ	/ɵbʱinet̪ri/
ଅଭିବାଦନ	/ɔbʱibaːd̪ɔnɔ/
ଅଭିଲେଖ	/ɵbʱilekʰɵ/
ଅଭ୍ୟସ୍ତ	/ɔbʱjɔst̪ɔ/
ଅମାବାସ୍ୟା	/ɵmaːbaːsjaː/
ଅମ୍ମୁ	/ɔmmu/
ଅମ୍ଳଜାନ	/ɔml̪ɔd͡ʒaːnɔ/
ଅରବିନ୍ଦ	/ɵɾɵbind̪ɵ/
ଅରୁଣ	/ɵruɳɵ/
ଅରୁଣାଚଳ	/ɵruɳaːt͡ʃɵl̪ɵ/
ଅର୍ଜନ	/ɵrd͡ʒɵnɵ/
ଅର୍ଜୁନ	/ɵrd͡ʒunɵ/
ଅର୍ଥ	/ɵrt̪ʰɵ/
ଅର୍ଥନୀତି	/ɵrt̪ʰɵnit̪i/
ଅର୍ଥନୈତିକ	/ɵrt̪ʰɵnɵit̪ikɵ/
ଅର୍ଥାତ	/ɵrt̪ʰaːt̪ɵ/
ଅର୍ପଣ	/ɵrpɵɳɵ/
ଅଲଗା	/ɵlɵgaː/
ଅଲିମ୍ପିକ	/ɵlimpikɵ/
ଅଲ୍ପନା	/ɔlpɔnaː/
ଅଳଙ୍କାର	/ɵl̪ɵŋkaːɾɵ/
ଅଳାଇଚ	/ɔl̪aːit͡ʃɔ/
ଅଳିଆ	/ɔl̪iaː/
ଅଳେଇଚ	/ɔl̪eit͡ʃɔ/
ଅଳ୍ପ	/ɵl̪pɵ/
ଅଳ୍ପଦିନ	/ɔl̪pɔd̪inɔ/
ଅଂଶ	/ɵŋsɵ/
ଅଶାନ୍ତି	/ɔsaːnt̪i/
ଅଂଶୁମାନ	/ɵŋsumaːnɵ/
ଅଶୋକ	/ɵsokɵ/
ଅଷ୍ଟମ	/ɵsʈɵmɵ/
ଅଷ୍ଟମୀ	/ɵsʈɵmi/
ଅଷ୍ଟ୍ରେଲିଆ	/ɵsʈreliaː/
ଅସଂଖ୍ୟ	/ɔsɔŋkʰjɔ/
ଅସନା	/ɔsɔnaː/
ଅସରପା	/ɔsɔɾɔpaː/
ଅସଲରେ	/ɔsɔlɔre/
ଅସହଯୋଗ	/ɔsɔhɔd͡ʒoɡɔ/
ଅସହ୍ୟ	/ɔsɔhjɔ/
ଅସିଗଲା	/ɔsiɡɔlaː/
ଅସିବାକୁ	/ɔsibaːku/
ଅସିମୀୟା	/ɵsimijaː/
ଅସୀମ	/ɔsimɔ/
ଅସୁବିଧା	/ɵsubid̪ʱaː/
ଅସୁସ୍ଥ	/ɔsust̪ʰɔ/
ଅସ୍ଥି	/ɵst̪ʰi/
ଅହମଦାବାଦ	/ɔhɔmɔd̪aːbaːd̪ɔ/
ଅାରେ	/ɔre/
ଆଃ	/aːh/
ଆଇ	/aːi/
ଆଇକୁ	/aːiku/
ଆଇନ	/aːinɵ/
ଆଇସ୍‌କ୍ରିମ୍‌	/aːiskrim/
ଆଇିମ	/aːimɔ/
ଆଈ	/aːi/
ଆଉ	/aːu/
ଆଉକିଛି	/aːukit͡ʃʰi/
ଆଉଗୋଟେ	/aːugoʈe/
ଆଉଜଣେ	/aːud͡ʒɔɳe/
ଆଉଥରେ	/aːut̪ʰɔre/
ଆଉରି	/aːuri/
ଆଉଁଷି	/aːũisi/
ଆଉସବୁ	/aːusɔbu/
ଆକ	/aːkɔ/
ଆକବର	/aːkɔbɔɾɔ/
ଆକବରଙ୍କ	/aːkɔbɔɾɔŋkɔ/
ଆକବରଙ୍କୁ	/aːkɔbɔɾɔŋku/
ଆକର୍ଷଣ	/aːkɵrsɵɳɵ/
ଆକାର	/aːkaːɾɵ/
ଆକାରର	/aːkaːɾɔɾɔ/
ଆକାରରେ	/aːkaːɾɵre/
ଆକାଶ	/aːkaːsɵ/
ଆକାଶକୁ	/aːkaːsɔku/
ଆକାଶବାଣୀ	/aːkaːsɵbaːɳi/
ଆକାଶର	/aːkaːsɔɾɔ/
ଆକାଶରୁ	/aːkaːsɔru/
ଆକାଶରେ	/aːkaːsɔre/
ଆଂକି	/aːŋki/
ଆଂକିବ	/aːŋkibɔ/
ଆଂକିବା	/aːŋkibaː/
ଆଂକିବାକୁ	/aːŋkibaːku/
ଆଂକିବି	/aːŋkibi/
ଆକୃତି	/aːkrut̪i/
ଆଂକେ	/aːŋke/
ଆକ୍ରମଣ	/aːkɾɵmɵɳɵ/
ଆଖ	/aːkʰɔ/
ଆଖି	/aːkʰi/
ଆଖିଥିଲା	/aːkʰit̪ʰilaː/
ଆଖିବୁଜି	/aːkʰibud͡ʒi/
ଆଖିର	/aːkʰiɾɔ/
ଆଖିରୁ	/aːkʰiru/
ଆଖିରେ	/aːkʰire/
ଆଖୁ	/aːkʰu/
ଆଗ	/aːɡɔ/
ଆଗକୁ	/aːɡɵku/
ଆଗରୁ	/aːɡɵru/
ଆଗରେ	/aːɡɵre/
ଆଗାମୀ	/aːgaːmi/
ଆଗୁଆ	/aːguaː/
ଆଗେ	/aːge/
ଆଗ୍ରହ	/aːgɾɵhɵ/
ଆଗ୍ରହରେ	/aːgɾɔhɔre/
ଆଗ୍ରହୀ	/aːgɾɵhi/
ଆଗ୍ରା	/aːgraː/
ଆଘାତ	/aːgʰaːt̪ɵ/
ଆଙ୍କିବାକୁ	/aːŋkibaːku/
ଆଙ୍ଗୁଠି	/aːŋguʈʰi/
ଆଙ୍ଗୁଠିମାନେ	/aːŋguʈʰimaːne/
ଆଙ୍ଗୁଠିରେ	/aːŋguʈʰire/
ଆଙ୍ଗୁଳି	/aːŋgul̪i/
ଆଚମ୍ୱିତ	/aːt͡ʃɔmuit̪ɔ/
ଆଚାର୍ଯ୍ୟ	/aːt͡ʃaːrd͡ʒjɵ/
ଆଛା	/aːt͡ʃʰaː/
ଆଛାଦିତ	/aːt͡ʃʰaːd̪it̪ɔ/
ଆଛୁ	/aːt͡ʃʰu/
ଆଜି	/aːd͡ʒi/
ଆଜିକାଲି	/aːd͡ʒikaːli/
ଆଜିର	/aːd͡ʒiɾɵ/
ଆଜ୍ଞା	/aːd͡ʒɲaː/
ଆଜ୍‌ମା	/aːd͡ʒmaː/
ଆଞ୍ଚଳିକ	/aːɲt͡ʃɵl̪ikɵ/
ଆଞ୍ଜୁଳା	/aːɲd͡ʒul̪aː/
ଆଟୁ	/aːʈu/
ଆଠ	/aːʈʰɵ/
ଆଠମଲ୍ଲିକ	/aːʈʰɵmɵllikɵ/
ଆଡକୁ	/aːɖɵku/
ଆଡ଼କୁ	/aːɖɵku/
ଆଡ଼କୁ	/aːɽɔku/
ଆଡ଼େ	/aːɽe/
ଆଣ	/aːɳɔ/
ଆଣି	/aːɳi/
ଆଣିଛ	/aːɳit͡ʃʰɔ/
ଆଣିଛନ୍ତି	/aːɳit͡ʃʰɔnt̪i/
ଆଣିଛି	/aːɳit͡ʃʰi/
ଆଣିଥାଏ	/aːɳit̪ʰaːe/
ଆଣିଥିଲା	/aːɳit̪ʰilaː/
ଆଣିଦିଅ	/aːɳid̪iɔ/
ଆଣିଦେବ	/aːɳid̪ebɔ/
ଆଣିପାର	/aːɳipaːɾɔ/
ଆଣିବ	/aːɳibɔ/
ଆଣିବା	/aːɳibaː/
ଆଣିବାକୁ	/aːɳibaːku/
ଆଣିବାଡୁ	/aːɳibaːɖu/
ଆଣିବି	/aːɳibi/
ଆଣିବୁ	/aːɳibu/
ଆଣିବେ	/aːɳibe/
ଆଣିଲ	/aːɳilɔ/
ଆଣିଲା	/aːɳilaː/
ଆଣିଲି	/aːɳili/
ଆଣିଲେ	/aːɳile/
ଆଣୁଛି	/aːɳut͡ʃʰi/
ଆଣୁଥିଲେ	/aːɳut̪ʰile/
ଆଣେ	/aːɳe/
ଆଣ୍ଟାରେ	/aːɳʈaːre/
ଆଣ୍ଟି	/aːɳʈi/
ଆଣ୍ଡ	/aːɳɖɵ/
ଆଦର	/aːd̪ɔɾɔ/
ଆଦାୟକୁ	/aːd̪aːjɔku/
ଆଦି	/aːd̪i/
ଆଦିତ୍ୟ	/aːd̪it̪jɵ/
ଆଦିବାସୀ	/aːd̪ibaːsi/
ଆଦିରେ	/aːd̪ire/
ଆଦେଶ	/aːd̪esɔ/
ଆଦୌ	/aːd̪ɔu/
ଆଧାର	/aːd̪ʱaːɾɵ/
ଆଧାରିତ	/aːd̪ʱaːrit̪ɵ/
ଆଧୁନିକ	/aːd̪ʱunikɵ/
ଆଧ୍ୟାତ୍ମିକ	/aːd̪ʱjaːt̪mikɵ/
ଆନନ୍ଦ	/aːnɵnd̪ɵ/
ଆନନ୍ଦଦାୟକ	/aːnɔnd̪ɔd̪aːjɔkɔ/
ଆନନ୍ଦର	/aːnɔnd̪ɔɾɔ/
ଆନନ୍ଦରେ	/aːnɔnd̪ɔre/
ଆନନ୍ଦିତ	/aːnɔnd̪it̪ɔ/
ଆନ୍ଟାର୍ଟିକା	/aːnʈaːrʈikaː/
ଆନ୍ତର୍ଜାତୀୟ	/aːnt̪ɵrd͡ʒaːt̪ijɵ/
ଆନ୍ଦୋଳନ	/aːnd̪ol̪ɵnɵ/
ଆନ୍ଧ୍ର	/aːnd̪ʱɾɵ/
ଆପଣ	/aːpɵɳɵ/
ଆପଣଂକୁ	/aːpɔɳɔŋku/
ଆପଣଙ୍କ	/aːpɵɳɵŋkɵ/
ଆପଣଙ୍କର	/aːpɔɳɔŋkɔɾɔ/
ଆପଣଙ୍କୁ	/aːpɵɳɵŋku/
ଆପଣତ	/aːpɔɳɔt̪ɔ/
ଆପଣମାନେ	/aːpɔɳɔmaːne/
ଆପଣାଇ	/aːpɔɳaːi/
ଆପତ୍ତି	/aːpɔt̪t̪i/
ଆପେ	/aːpe/
ଆପ୍ପା	/aːppaː/
ଆଫ୍ରିକା	/aːpʰrikaː/
ଆଫ୍ରିକାର	/aːpʰrikaːɾɵ/
ଆଫ୍ରିକୀୟ	/aːpʰrikijɵ/
ଆବର୍ଦ୍ଧକ	/aːbɔrd̪d̪ʱɔkɔ/
ଆବଶ୍ୟକ	/aːbɵsjɵkɵ/
ଆବଶ୍ୟକତା	/aːbɵsjɵkɵt̪aː/
ଆବିଷ୍କାର	/aːbiskaːɾɵ/
ଆମ	/aːmɵ/
ଆମକୁ	/aːmɔku/
ଆମଭଳି	/aːmɔbʰɔl̪i/
ଆମର	/aːmɵɾɵ/
ଆମେ	/aːme/
ଆମେରିକା	/aːmerikaː/
ଆମେରିକାର	/aːmerikaːɾɔ/
ଆମେରିକାରେ	/aːmerikaːre/
ଆମେରିକୀୟ	/aːmerikijɵ/
ଆମ୍ବ	/aːmbɵ/
ଆମ୍ବାସୁର	/aːmbaːsuɾɔ/
ଆମ୍ମା	/aːmmaː/
ଆମ୍ମୀ	/aːmmi/
ଆମ୍ମୀକୁ	/aːmmiku/
ଆମ୍ୱ	/aːmuɔ/
ଆୟ	/aːjɵ/
ଆୟୋଜନ	/aːjod͡ʒɵnɵ/
ଆୟୋଜିତ	/aːjod͡ʒit̪ɵ/
ଆର	/aːɾɵ/
ଆରପଟେ	/aːɾɔpɔʈe/
ଆରବ	/aːɾɵbɵ/
ଆରମ୍ଭ	/aːɾɵmbʰɵ/
ଆରାମରେ	/aːraːmɔre/
ଆରେ	/aːre/
ଆର୍ଥିକ	/aːrt̪ʰikɵ/
ଆଲମାରୀ	/aːlɔmaːri/
ଆଲିଙ୍ଗନ	/aːliŋɡɔnɔ/
ଆଲୁଅ	/aːluɔ/
ଆଲୁଅରେ	/aːluɔre/
ଆଲୋକ	/aːlokɵ/
ଆଲୋକିତ	/aːlokit̪ɔ/
ଆଲୋଚନା	/aːlot͡ʃɵnaː/
ଆଳୁ	/aːl̪u/
ଆଳୁ-ମାଳୁ-କାଳୁ	/aːl̪u-maːl̪u-kaːl̪u/
ଆଳୁସବୁ	/aːl̪usɔbu/
ଆଶା	/aːsaː/
ଆଶୀର୍ବାଦ	/aːsirbaːd̪ɔ/
ଆଶୁତୋଷ	/aːsut̪osɵ/
ଆଶ୍ଚର୍ଯ୍ୟ	/aːst͡ʃɔrd͡ʒjɔ/
ଆଶ୍ଚର୍ଯ଼୍ୟ	/aːst͡ʃɔrd͡ʒɔjɔ/
ଆଶ୍ଚର୍ଯ୍ୟଚକିତ	/aːst͡ʃɔrd͡ʒjɔt͡ʃɔkit̪ɔ/
ଆଶ୍ଚର୍ଯ୍ୟଜନକ	/aːst͡ʃɔrd͡ʒjɔd͡ʒɔnɔkɔ/
ଆଶ୍ରମ	/aːsɾɵmɵ/
ଆଶ୍ରମବାସୀ	/aːsɾɔmɔbaːsi/
ଆଶ୍ରମର	/aːsɾɔmɔɾɔ/
ଆଶ୍ରମରେ	/aːsɾɔmɔre/
ଆଶ୍ୱିନ	/aːsuinɵ/
ଆଷାଢ଼	/aːsaːɖʱɵ/
ଆସ	/aːsɔ/
ଆସନ	/aːsɵnɵ/
ଆସନି	/aːsɔni/
ଆସନ୍ତା	/aːsɔnt̪aː/
ଆସନ୍ତି	/aːsɔnt̪i/
ଆସି	/aːsi/
ଆସିଗଲା	/aːsiɡɔlaː/
ଆସିଗଲେ	/aːsiɡɔle/
ଆସିଛ	/aːsit͡ʃʰɔ/
ଆସିଛନ୍ତି	/aːsit͡ʃʰɔnt̪i/
ଆସିଛି	/aːsit͡ʃʰi/
ଆସିଛୁ	/aːsit͡ʃʰu/
ଆସିଥାଏ	/aːsit̪ʰaːe/
ଆସିଥାଏଇମ୍ମା	/aːsit̪ʰaːeimmaː/
ଆସିଥିବା	/aːsit̪ʰibaː/
ଆସିଥିଲେ	/aːsit̪ʰile/
ଆସିନାହିଁ	/aːsinaːhĩ/
ଆସିପାରନ୍ତି	/aːsipaːɾɔnt̪i/
ଆସିପାରିଲାନି	/aːsipaːrilaːni/
ଆସିବ	/aːsibɔ/
ଆସିବା	/aːsibaː/
ଆସିବାକୁ	/aːsibaːku/
ଆସିବାର	/aːsibaːɾɔ/
ଆସିବି	/aːsibi/
ଆସିବୁ	/aːsibu/
ଆସିବେ	/aːsibe/
ଆସିଯାଇଥିଲା	/aːsid͡ʒaːit̪ʰilaː/
ଆସିଯିବ	/aːsid͡ʒibɔ/
ଆସିଲ	/aːsilɔ/
ଆସିଲା	/aːsilaː/
ଆସିଲାଣି	/aːsilaːɳi/
ଆସିଲି	/aːsili/
ଆସିଲେ	/aːsile/
ଆସିଲେଣି	/aːsileɳi/
ଆସିଲେନି	/aːsileni/
ଆସୁ	/aːsu/
ଆସୁଛନ୍ତି	/aːsut͡ʃʰɔnt̪i/
ଆସୁଛି	/aːsut͡ʃʰi/
ଆସୁଥିବା	/aːsut̪ʰibaː/
ଆସୁଥିବାର	/aːsut̪ʰibaːɾɔ/
ଆସୁଥିଲା	/aːsut̪ʰilaː/
ଆସୁନଥିବାରୁ	/aːsunɔt̪ʰibaːru/
ଆସୁନୁ	/aːsunu/
ଆସେ	/aːse/
ଆସେନି	/aːseni/
ଆସ୍ତେ	/aːst̪e/
ଆସ୍ତେକରି	/aːst̪ekɔri/
ଆହା	/aːhaː/
ଆହୁରି	/aːhuri/
ଇଉରୋପ	/iuropɵ/
ଇଉରୋପୀୟ	/iuropijɵ/
ଇଏ	/ie/
ଇଙ୍ଗିତ	/iŋgit̪ɔ/
ଇଚ୍ଛା	/it͡ʃt͡ʃʰaː/
ଇଛା	/it͡ʃʰaː/
ଇଂଜିନିୟରିଂ	/iŋd͡ʒinijɔriŋ/
ଇଞ୍ଚ	/iɲt͡ʃɵ/
ଇଞ୍ଜିନିୟରିଂ	/iɲd͡ʒinijɵriŋ/
ଇଟା	/iʈaː/
ଇଟାର	/iʈaːɾɔ/
ଇଣ୍ଟରନେଟ	/iɳʈɵɾɵneʈɵ/
ଇଣ୍ଡିଆ	/iɳɖiaː/
ଇଣ୍ଡିଆନ	/iɳɖiaːnɵ/
ଇଣ୍ଡେକ୍ସ	/iɳɖeksɵ/
ଇତିହାସ	/it̪ihaːsɵ/
ଇତ୍ଯାଦି	/it̪d͡ʒaːd̪i/
ଇତ୍ୟାଦି	/it̪jaːd̪i/
ଇନଷ୍ଟିଚ୍ୟୁଟ	/inɵsʈit͡ʃjuʈɵ/
ଇନ୍ଦିରା	/ind̪iraː/
ଇନ୍ଦ୍ର	/ind̪ɾɵ/
ଇବୋକ୍	/ibok/
ଇବ୍ରାହିମ୍	/ibraːhim/
ଇମ୍ମା	/immaː/
ଇମ୍ମାଙ୍କ	/immaːŋkɔ/
ଇଂରାଜୀ	/iŋraːd͡ʒi/
ଇଂରାଜୀରେ	/iŋraːd͡ʒire/
ଇଂରେଜ	/iŋred͡ʒɵ/
ଇଂଲଣ୍ଡ	/iŋlɵɳɖɵ/
ଇଲେକଟ୍ରିକ୍	/ilekɔʈrik/
ଇଶତ୍	/isɔt̪/
ଇଷ୍	/is/
ଉଁ	/ũ/
ଉଇଁଲା	/uĩlaː/
ଉଇଁଲେ	/uĩle/
ଉକ୍ତ	/ukt̪ɵ/
ଉଙ୍କି	/uŋki/
ଉଚିତ	/ut͡ʃit̪ɵ/
ଉଚିତ୍	/ut͡ʃit̪/
ଉଚ୍ଚ	/ut͡ʃt͡ʃɵ/
ଉଚ୍ଚତା	/ut͡ʃt͡ʃɵt̪aː/
ଉଚ୍ଚାରଣ	/ut͡ʃt͡ʃaːɾɵɳɵ/
ଉଜ୍ଜ୍ଵଳ	/ud͡ʒd͡ʒuɔl̪ɔ/
ଉଜ୍ଜ୍ୱଳ	/ud͡ʒd͡ʒuɔl̪ɔ/
ଉଞ୍ଚା	/uɲt͡ʃaː/
ଉଠାଇ	/uʈʰaːi/
ଉଠାଇଲେ	/uʈʰaːile/
ଉଠି	/uʈʰi/
ଉଠିପଡି	/uʈʰipɔɖi/
ଉଠିବା	/uʈʰibaː/
ଉଠିଲା	/uʈʰilaː/
ଉଠିଲି	/uʈʰili/
ଉଠିଲେ	/uʈʰile/
ଉଠୁ	/uʈʰu/
ଉଠୁଥିବା	/uʈʰut̪ʰibaː/
ଉଠୁଥିଲା	/uʈʰut̪ʰilaː/
ଉଠେଇ	/uʈʰei/
ଉଠେଇଲି	/uʈʰeili/
ଉଠ୍	/uʈʰ/
ଉଡ଼	/uɽɔ/
ଉଡନ୍ତି	/uɖɔnt̪i/
ଉଡ଼ା-ଜାହାଜକୁ	/uɽaː-d͡ʒaːhaːd͡ʒɔku/
ଉଡ଼ାଇବାକୁ	/uɽaːibaːku/
ଉଡି	/uɖi/
ଉଡ଼ି	/uɽi/
ଉଡ଼ିଗଲା	/uɽiɡɔlaː/
ଉଡ଼ିଚାଲ	/uɽit͡ʃaːlɔ/
ଉଡିଜିବା	/uɖid͡ʒibaː/
ଉଡ଼ିପାର	/uɽipaːɾɔ/
ଉଡ଼ିପାରେ	/uɽipaːre/
ଉଡିବା	/uɖibaː/
ଉଡ଼ିବାକୁ	/uɽibaːku/
ଉଡ଼ିବୁଲନ୍ତି	/uɽibulɔnt̪i/
ଉଡିବୁଲିବାକୁ	/uɖibulibaːku/
ଉଡିଯାଏ	/uɖid͡ʒaːe/
ଉଡିଲା	/uɖilaː/
ଉଡ଼ୁଛନ୍ତି	/uɽut͡ʃʰɔnt̪i/
ଉଡୁଥିବା	/uɖut̪ʰibaː/
ଉଡ଼େଇ	/uɽei/
ଉଡ଼େଇବା	/uɽeibaː/
ଉଡ଼େଇବାକୁ	/uɽeibaːku/
ଉଡ଼େଇଲା	/uɽeilaː/
ଉତ୍କଳ	/ut̪kɵl̪ɵ/
ଉତ୍ତମ	/ut̪t̪ɵmɵ/
ଉତ୍ତର	/ut̪t̪ɵɾɵ/
ଉତ୍ତରକୁ	/ut̪t̪ɔɾɔku/
ଉତ୍ତରରେ	/ut̪t̪ɔɾɔre/
ଉତ୍ପନ୍ନ	/ut̪pɔnnɔ/
ଉତ୍ପନ୍ନର	/ut̪pɔnnɔɾɔ/
ଉତ୍ପାଦନ	/ut̪paːd̪ɵnɵ/
ଉତ୍ସବ	/ut̪sɵbɵ/
ଉତ୍ସାହିତ	/ut̪saːhit̪ɔ/
ଉତ୍ସୁକ	/ut̪sukɔ/
ଉଦୟ	/ud̪ɵjɵ/
ଉଦୟଗିରି	/ud̪ɵjɵgiri/
ଉଦାହରଣ	/ud̪aːhɵɾɵɳɵ/
ଉଦ୍ଦେଶ୍ୟରେ	/ud̪d̪esjɵre/
ଉଦ୍ଧାର	/ud̪d̪ʱaːɾɵ/
ଉଦ୍ଭାବନ	/ud̪bʱaːbɵnɵ/
ଉଦ୍ଭାବିତ	/ud̪bʱaːbit̪ɔ/
ଉଦ୍ଭିଦ	/ud̪bʱid̪ɵ/
ଉଦ୍ୟାନ	/ud̪jaːnɵ/
ଉନ୍ନତ	/unnɵt̪ɵ/
ଉନ୍ନତି	/unnɵt̪i/
ଉନ୍ନି	/unni/
ଉପ	/upɵ/
ଉପକରଣ	/upɵkɵɾɵɳɵ/
ଉପକାର	/upɵkaːɾɵ/
ଉପନ୍ୟାସ	/upɵnjaːsɵ/
ଉପବାସ	/upɵbaːsɵ/
ଉପଭୋଗ	/upɔbʱoɡɔ/
ଉପମା	/upɔmaː/
ଉପଯୁକ୍ତ	/upɵd͡ʒukt̪ɵ/
ଉପଯୋଗ	/upɵd͡ʒoɡɵ/
ଉପର	/upɵɾɵ/
ଉପରକୁ	/upɵɾɵku/
ଉପରବେଳା	/upɔɾɔbel̪aː/
ଉପରଭାଗରେ	/upɔɾɔbʱaːɡɔre/
ଉପରୁ	/upɔru/
ଉପରେ	/upɵre/
ଉପଲବ୍ଧ	/upɵlɵbd̪ʱɵ/
ଉପସ୍ଥାପନା	/upɵst̪ʰaːpɵnaː/
ଉପସ୍ଥିତ	/upɵst̪ʰit̪ɵ/
ଉପସ୍ଥିତି	/upɵst̪ʰit̪i/
ଉପହାର	/upɔhaːɾɔ/
ଉପାଡ଼ି	/upaːɽi/
ଉପାଡ଼ିବ	/upaːɽibɔ/
ଉପାଦାନ	/upaːd̪aːnɵ/
ଉପାଧି	/upaːd̪ʱi/
ଉପାୟ	/upaːjɔ/
ଉପାୟଟି	/upaːjɔʈi/
ଉପାସନା	/upaːsɵnaː/
ଉପେକ୍ଷା	/upekʰjaː/
ଉପେନ୍ଦ୍ର	/upend̪ɾɵ/
ଉଭୟ	/ubʰɵjɵ/
ଉଭାନ୍	/ubʱaːn/
ଉର୍ଦ୍ଦୁ	/urd̪d̪u/
ଉଲ୍ଲେଖ	/ullekʰɵ/
ଉଷୁମ	/usumɔ/
ଉଷ୍ଣଜଲବାୟୁ	/usɳɔd͡ʒɔlɔbaːju/
ଊଟି	/uʈi/
ଋତୁ	/rut̪u/
ଋତୁକୁ	/rut̪uku/
ଋତୁର	/rut̪uɾɔ/
ଋତୁରେ	/rut̪ure/
ଏଃ	/eh/
ଏଇ	/ei/
ଏଇଟା	/eiʈaː/
ଏଇଟି	/eiʈi/
ଏଇଠି	/eiʈʰi/
ଏଇନା	/einaː/
ଏଇଲେ	/eile/
ଏକ	/ekɵ/
ଏକକ	/ekɵkɵ/
ଏକତ୍ରିତ	/ekɔt̪rit̪ɔ/
ଏକଥା	/ekɔt̪ʰaː/
ଏକଦମ୍‌	/ekɔd̪ɔm/
ଏକମାତ୍ର	/ekɵmaːt̪ɾɵ/
ଏକଲା	/ekɔlaː/
ଏକା	/ekaː/
ଏକାଠି	/ekaːʈʰi/
ଏକାଡେମି	/ekaːɖemi/
ଏକାଡେମୀ	/ekaːɖemi/
ଏକାଦଶୀ	/ekaːd̪ɵsi/
ଏକାଧିକ	/ekaːd̪ʱikɵ/
ଏକୁଟିଆ	/ekuʈiaː/
ଏଗୁଡ଼ାକ	/eguɽaːkɔ/
ଏଗୁଡିକ	/eguɖikɔ/
ଏଗୁଡ଼ିକ	/eguɽikɔ/
ଏଚ	/et͡ʃɵ/
ଏଚ୍	/et͡ʃ/
ଏଟା	/eʈaː/
ଏଠାକାର	/eʈʰaːkaːɾɵ/
ଏଠାକୁ	/eʈʰaːku/
ଏଠାରେ	/eʈʰaːre/
ଏଠି	/eʈʰi/
ଏଠୁ	/eʈʰu/
ଏଣୁ	/eɳu/
ଏଣ୍ଡ	/eɳɖɵ/
ଏତ	/et̪ɔ/
ଏତିକି	/et̪iki/
ଏତେ	/et̪e/
ଏତେଜଣ	/et̪ed͡ʒɔɳɔ/
ଏତେଦୂର	/et̪ed̪uɾɔ/
ଏତେବେଳ	/et̪ebel̪ɔ/
ଏତେବେଳେ	/et̪ebel̪e/
ଏଥର	/et̪ʰɔɾɔ/
ଏଥରକ	/et̪ʰɔɾɔkɔ/
ଏଥି	/et̪ʰi/
ଏଥିପାଇଁ	/et̪ʰipaːĩ/
ଏଥିର	/et̪ʰiɾɔ/
ଏଥିରୁ	/et̪ʰiru/
ଏଥିରେ	/et̪ʰire/
ଏପଟ	/epɔʈɔ/
ଏପଟ-ସେପଟ	/epɔʈɔ-sepɔʈɔ/
ଏପଟକୁ	/epɔʈɔku/
ଏପରି	/epɵri/
ଏପରିକି	/epɵriki/
ଏପର୍ଯ୍ୟନ୍ତ	/epɔrd͡ʒjɔnt̪ɔ/
ଏପ୍ରିଲ	/eprilɵ/
ଏପ୍ରିଲ୍	/epril/
ଏଫୁଲରୁ	/epʰulɔru/
ଏବଂ	/ebɵŋ/
ଏବାଟେ	/ebaːʈe/
ଏବିଷୟରେ	/ebisɔjɔre/
ଏବେ	/ebe/
ଏବେକାର	/ebekaːɾɵ/
ଏବେବି	/ebebi/
ଏଭଳି	/ebʰɔl̪i/
ଏମ	/emɵ/
ଏମାନଙ୍କୁ	/emaːnɔŋku/
ଏମାନେ	/emaːne/
ଏମିତି	/emit̪i/
ଏମିତିକି	/emit̪iki/
ଏମିତିରେ	/emit̪ire/
ଏମୁଣ୍ଡରୁ	/emuɳɖɔru/
ଏମ୍	/em/
ଏସ	/esɵ/
ଏସବୁ	/esɔbu/
ଏସବୁକୁ	/esɔbuku/
ଏସିଆ	/esiaː/
ଏସିଆର	/esiaːɾɵ/
ଏସିଡ	/esiɖɵ/
ଏସୀୟ	/esijɵ/
ଏସ୍	/es/
ଏହା	/ehaː/
ଏହାକୁ	/ehaːku/
ଏହାପରେ	/ehaːpɵre/
ଏହାଯୋଗୁଁ	/ehaːd͡ʒogũ/
ଏହାର	/ehaːɾɵ/
ଏହି	/ehi/
ଏହିଦିନ	/ehid̪inɵ/
ଏହିପରି	/ehipɵri/
ଐତିହାସିକ	/ɵit̪ihaːsikɵ/
ଐତିହ୍ୟ	/ɵit̪ihjɵ/
ଓଃ	/oh/
ଓଜନ	/od͡ʒɵnɵ/
ଓଜନିଆ	/od͡ʒɔniaː/
ଓଟ	/oʈɔ/
ଓଠ	/oʈʰɔ/
ଓଠରେ	/oʈʰɔre/
ଓଡିଆ	/oɖiaː/
ଓଡ଼ିଆ	/oɽiaː/
ଓଡ଼ିଆରେ	/oɽiaːre/
ଓଡିଶା	/oɖisaː/
ଓଡ଼ିଶା	/oɽisaː/
ଓଡ଼ିଶାର	/oɽisaːɾɵ/
ଓଡ଼ିଶାରେ	/oɽisaːre/
ଓଡ଼ିଶୀ	/oɽisi/
ଓଢ଼ଣୀ	/oɽʱɔɳi/
ଓଣମ୍	/oɳɔm/
ଓଦା	/od̪aː/
ଓଭର	/obʰɔɾɔ/
ଓଲଟା	/olɔʈaː/
ଓଲିଉଡ଼	/oliuɖɵ/
ଓଲ୍ହାଇ	/olhaːi/
ଓଷା	/osaː/
ଓସ୍ତ	/ost̪ɔ/
ଓସ୍ତଗଛ	/ost̪ɔɡɔt͡ʃʰɔ/
ଓସ୍ତଗଛରେ	/ost̪ɔɡɔt͡ʃʰɔre/
ଓହଳାଇ	/ohɔl̪aːi/
ଓହଳି	/ohɔl̪i/
ଓହଳେଇ	/ohɔl̪ei/
ଓହୋ	/oho/
ଓହ୍ଲଉଥିବା	/ohlɔut̪ʰibaː/
ଓହ୍ଲାଇ	/ohlaːi/
ଓହ୍ଲାଇବା	/ohlaːibaː/
ଓହ୍ଲାଏ	/ohlaːe/
ଓହ୍ଲେଇଲା	/ohleilaː/
ଔଷଧ	/ɵusɵd̪ʱɵ/
ଔଷଧୀୟ	/ɵusɵd̪ʱijɵ/
କଅଁଳ	/kɔɔ̃l̪ɔ/
କଅଁଳିଆ	/kɔɔ̃l̪iaː/
କଇଁଚ	/kɔĩt͡ʃɔ/
କଇଁଚିଟିରେ	/kɔĩt͡ʃiʈire/
କଇଁଫୁଲରେ	/kɔĩpʰulɔre/
କଉଡ଼ି	/kɵuɽi/
କଉତୁକିଆ	/kɔut̪ukiaː/
କକା	/kɔkaː/
କଂଗ୍ରେସ	/kɵŋgresɵ/
କଙ୍କି	/kɔŋki/
କଚକଚିଆ	/kɔt͡ʃɔkɔt͡ʃiaː/
କଚ୍	/kɔt͡ʃ/
କଞ୍ଚା	/kɵɲt͡ʃaː/
କଟକ	/kɵʈɵkɵ/
କଟକର	/kɵʈɵkɵɾɵ/
କଟକରେ	/kɵʈɵkɵre/
କଟା	/kɔʈaː/
କଟି	/kɔʈi/
କଟିବାକୁ	/kɔʈibaːku/
କଟିଲା	/kɔʈilaː/
କଠିନ	/kɔʈʰinɔ/
କଠୋରିରେ	/kɔʈʰorire/
କଡ଼ରେ	/kɔɽɔre/
କଢ଼େଇ	/kɔɽʱei/
କଣ	/kɵɳɵ/
କଣରେ	/kɔɳɔre/
କଣାଯୁକ୍ତ	/kɔɳaːd͡ʒukt̪ɔ/
କଣିକା	/kɵɳikaː/
କଣ୍ଟା	/kɵɳʈaː/
କଣ୍ଟାରେ	/kɔɳʈaːre/
କଣ୍ଠଦାନ	/kɵɳʈʰɵd̪aːnɵ/
କଣ୍ଠରେ	/kɔɳʈʰɔre/
କଣ୍ଢେଇ	/kɵɳɖʱei/
କଥା	/kɵt̪ʰaː/
କଥାକୁ	/kɔt̪ʰaːku/
କଥାଚିତ୍ର	/kɵt̪ʰaːt͡ʃit̪ɾɵ/
କଥାଚିତ୍ରରେ	/kɵt̪ʰaːt͡ʃit̪ɾɵre/
କଥାଟା	/kɔt̪ʰaːʈaː/
କଥାଟାକୁ	/kɔt̪ʰaːʈaːku/
କଥାବାର୍ତ୍ତା	/kɔt̪ʰaːbaːrt̪t̪aː/
କଥାରେ	/kɔt̪ʰaːre/
କଥିତ	/kɵt̪ʰit̪ɵ/
କଦଳୀ	/kɵd̪ɵl̪i/
କଦାପି	/kɔd̪aːpi/
କନଭେୟାର୍	/kɔnɔbʱejaːr/
କନେକ୍ଟିକଟ	/kɔnekʈikɔʈɔ/
କନ୍ଧମାଳ	/kɵnd̪ʱɵmaːl̪ɵ/
କନ୍ନଡ଼	/kɵnnɵɖɵ/
କନ୍ୟା	/kɵnjaː/
କନ୍ୟାକୁ	/kɔnjaːku/
କପଡା	/kɔpɔɖaː/
କପଡ଼ା	/kɔpɔɽaː/
କପଡ଼ାରେ	/kɔpɔɽaːre/
କପାଳ	/kɔpaːl̪ɔ/
କପ୍	/kɔp/
କପ୍‌ର	/kɔpɾɔ/
କବାଟ	/kɔbaːʈɔ/
କବାଟକୁ	/kɔbaːʈɔku/
କବାଟରେ	/kɔbaːʈɔre/
କବାଟ୍	/kɔbaːʈ/
କବାଡ଼ି	/kɔbaːɽi/
କବାଡ଼ିବାଲା	/kɔbaːɽibaːlaː/
କବି	/kɵbi/
କବିତା	/kɵbit̪aː/
କମ	/kɵmɵ/
କମର	/kɔmɔɾɔ/
କମରପଟି	/kɔmɔɾɔpɔʈi/
କମଳ	/kɵmɵl̪ɵ/
କମଳା	/kɔmɔl̪aː/
କମିଯାଏ	/kɵmid͡ʒaːe/
କମିଲାନି	/kɔmilaːni/
କମ୍	/kɵm/
କମ୍ପନ	/kɔmpɔnɔ/
କମ୍ପାନୀ	/kɵmpaːni/
କମ୍ପିଲା	/kɔmpilaː/
କମ୍ପ୍ୟୁଟର	/kɵmpjuʈɵɾɵ/
କମ୍ବଳ	/kɔmbɔl̪ɔ/
କମ୍ୟୁନିଷ୍ଟ	/kɵmjunisʈɵ/
କର	/kɵɾɵ/
କରନା	/kɔɾɔnaː/
କରନି	/kɔɾɔni/
କରନ୍ତି	/kɵɾɵnt̪i/
କରନ୍ତୁ	/kɵɾɵnt̪u/
କରା	/kɵraː/
କରାଇ	/kɵraːi/
କରାଇଛନ୍ତି	/kɔraːit͡ʃʰɔnt̪i/
କରାଇଥିଲେ	/kɵraːit̪ʰile/
କରାଏ	/kɔraːe/
କରାଗଲା	/kɵraːɡɵlaː/
କରାମତି	/kɔraːmɔt̪i/
କରାମାତି	/kɔraːmaːt̪i/
କରାଯାଇ	/kɵraːd͡ʒaːi/
କରାଯାଇଛି	/kɵraːd͡ʒaːit͡ʃʰi/
କରାଯାଇଥାଏ	/kɵraːd͡ʒaːit̪ʰaːe/
କରାଯାଇଥିବା	/kɵraːd͡ʒaːit̪ʰibaː/
କରାଯାଇଥିଲା	/kɵraːd͡ʒaːit̪ʰilaː/
କରାଯାଉଛି	/kɵraːd͡ʒaːut͡ʃʰi/
କରାଯାଉଥିବା	/kɵraːd͡ʒaːut̪ʰibaː/
କରାଯାଉଥିଲା	/kɵraːd͡ʒaːut̪ʰilaː/
କରାଯାଏ	/kɵraːd͡ʒaːe/
କରାଯିବ	/kɵraːd͡ʒibɵ/
କରି	/kɵri/
କରିଉଠିଲେ	/kɔriuʈʰile/
କରିକି	/kɔriki/
କରିଛ	/kɔrit͡ʃʰɔ/
କରିଛନ୍ତି	/kɵrit͡ʃʰɵnt̪i/
କରିଛି	/kɵrit͡ʃʰi/
କରିଛୁ	/kɔrit͡ʃʰu/
କରିଥଲେ	/kɔrit̪ʰɔle/
କରିଥାଏ	/kɵrit̪ʰaːe/
କରିଥାନ୍ତ	/kɔrit̪ʰaːnt̪ɔ/
କରିଥାନ୍ତି	/kɵrit̪ʰaːnt̪i/
କରିଥିବା	/kɵrit̪ʰibaː/
କରିଥିଲା	/kɵrit̪ʰilaː/
କରିଥିଲେ	/kɵrit̪ʰile/
କରିଦିଅନ୍ତି	/kɔrid̪iɔnt̪i/
କରିଦେବକି	/kɔrid̪ebɔki/
କରିଦେବା	/kɔrid̪ebaː/
କରିଦେବି	/kɔrid̪ebi/
କରିଦେଲା	/kɔrid̪elaː/
କରିଦେଲେ	/kɵrid̪ele/
କରିନଥାନ୍ତି	/kɔrinɔt̪ʰaːnt̪i/
କରିନି	/kɔrini/
କରିନେଲେ	/kɔrinele/
କରିପାର	/kɔripaːɾɔ/
କରିପାରନ୍ତି	/kɔripaːɾɔnt̪i/
କରିପାରି	/kɔripaːri/
କରିପାରିବ	/kɔripaːribɔ/
କରିପାରିବି	/kɔripaːribi/
କରିପାରିବୁ	/kɔripaːribu/
କରିପାରିବେ	/kɵripaːribe/
କରିପାରିଲା	/kɔripaːrilaː/
କରିପାରିଲି	/kɔripaːrili/
କରିପାରେ	/kɔripaːre/
କରିବ	/kɵribɵ/
କରିବା	/kɵribaː/
କରିବାକୁ	/kɵribaːku/
କରିବାପାଇଁ	/kɵribaːpaːĩ/
କରିବାର	/kɵribaːɾɵ/
କରିବାରେ	/kɵribaːre/
କରିବି	/kɔribi/
କରିବିନି	/kɔribini/
କରିବୁ	/kɔribu/
କରିବେ	/kɵribe/
କରିଲା	/kɔrilaː/
କରିଲେ	/kɔrile/
କରିଲେଣି	/kɔrileɳi/
କରୁ	/kɔru/
କରୁଛ	/kɔrut͡ʃʰɔ/
କରୁଛନ୍ତି	/kɵrut͡ʃʰɵnt̪i/
କରୁଛି	/kɵrut͡ʃʰi/
କରୁଛୁ	/kɔrut͡ʃʰu/
କରୁଥାନ୍ତି	/kɔrut̪ʰaːnt̪i/
କରୁଥିବା	/kɵrut̪ʰibaː/
କରୁଥିବାର	/kɔrut̪ʰibaːɾɔ/
କରୁଥିଲା	/kɵrut̪ʰilaː/
କରୁଥିଲି	/kɔrut̪ʰili/
କରୁଥିଲେ	/kɵrut̪ʰile/
କରୁନଥିଲା	/kɔrunɔt̪ʰilaː/
କରୁନଥିଲେ	/kɔrunɔt̪ʰile/
କରେ	/kɵre/
କରେନାହିଁ	/kɔrenaːhĩ/
କର୍କଟ	/kɵrkɵʈɵ/
କର୍ଣ୍ଣାଟକ	/kɵrɳɳaːʈɵkɵ/
କର୍ମ	/kɵrmɵ/
କର୍ମଚାରୀଙ୍କୁ	/kɔrmɔt͡ʃaːriŋku/
କର୍ମଠ	/kɔrmɔʈʰɔ/
କର୍ମଶାଳା	/kɵrmɵsaːl̪aː/
କର୍ମଶାଳାରେ	/kɵrmɵsaːl̪aːre/
କଲ	/kɔlɔ/
କଲମ	/kɔlɔmɔ/
କଲା	/kɵlaː/
କଲାତ୍ମକ	/kɔlaːt̪mɔkɔ/
କଲାପରେ	/kɔlaːpɔre/
କଲି	/kɵli/
କଲିକତା	/kɵlikɵt̪aː/
କଲୁ	/kɔlu/
କଲେ	/kɵle/
କଲେଜ	/kɵled͡ʒɵ/
କଲେଣି	/kɔleɳi/
କଲେମଧ୍ୟ	/kɔlemɔd̪ʱjɔ/
କଳା	/kɵl̪aː/
କଳାକାର	/kɵl̪aːkaːɾɵ/
କଳାଛିଟ	/kɔl̪aːt͡ʃʰiʈɔ/
କଳାଜାଇଟିଏ	/kɔl̪aːd͡ʒaːiʈie/
କଳାଟା	/kɔl̪aːʈaː/
କଳାପଟା	/kɔl̪aːpɔʈaː/
କଳାପଟାରେ	/kɔl̪aːpɔʈaːre/
କଳାମେଘ	/kɔl̪aːmeɡʱɔ/
କଳାହାଣ୍ଡି	/kɵl̪aːhaːɳɖi/
କଳିଙ୍ଗ	/kɵl̪iŋɡɵ/
କଳ୍ପନା	/kɔl̪pɔnaː/
କଶ୍ମିରୀ	/kɵsmiri/
କଷିବାକୁ	/kɔsibaːku/
କଷୁଥିଲା	/kɔsut̪ʰilaː/
କଷ୍ଟ	/kɵsʈɵ/
କଷ୍ଟକର	/kɔsʈɔkɔɾɔ/
କଷ୍ଟରେ	/kɔsʈɔre/
କହ	/kɔhɔ/
କହନ୍ତି	/kɵhɵnt̪i/
କହି	/kɵhi/
କହିଛନ୍ତି	/kɔhit͡ʃʰɔnt̪i/
କହିଥାନ୍ତି	/kɔhit̪ʰaːnt̪i/
କହିଥିଲା	/kɔhit̪ʰilaː/
କହିଥିଲି	/kɔhit̪ʰili/
କହିଥିଲେ	/kɵhit̪ʰile/
କହିଦେ	/kɔhid̪e/
କହିଦେଇ	/kɔhid̪ei/
କହିଦେବି	/kɔhid̪ebi/
କହିଦେବୁ	/kɔhid̪ebu/
କହିପାରିବ	/kɔhipaːribɔ/
କହିପାରିବୁନି	/kɔhipaːribuni/
କହିବା	/kɵhibaː/
କହିବାକୁ	/kɔhibaːku/
କହିବିନି	/kɔhibini/
କହିବୁ	/kɔhibu/
କହିବୁନି	/kɔhibuni/
କହିବେ	/kɵhibe/
କହିଲା	/kɔhilaː/
କହିଲି	/kɔhili/
କହିଲିକି	/kɔhiliki/
କହିଲୁ	/kɔhilu/
କହିଲେ	/kɵhile/
କହିଲେନି	/kɔhileni/
କହୁ	/kɔhu/
କହୁଛନ୍ତି	/kɔhut͡ʃʰɔnt̪i/
କହୁଛି	/kɔhut͡ʃʰi/
କହୁଛୁ	/kɔhut͡ʃʰu/
କହୁଥାନ୍ତି	/kɔhut̪ʰaːnt̪i/
କହୁଥିଲା	/kɔhut̪ʰilaː/
କହୁଥିଲେ	/kɔhut̪ʰile/
କହୁନୁ	/kɔhunu/
କହେ	/kɔhe/
କାଆ	/kaːaː/
କାଇଁ	/kaːĩ/
କାଇଁକି	/kaːĩki/
କାଉ	/kaːu/
କାଉକୁ	/kaːuku/
କାଉଟି	/kaːuʈi/
କାଉଟିଏ	/kaːuʈie/
କାକଟପୁର	/kaːkɵʈɵpuɾɵ/
କାକୁତି	/kaːkut̪i/
କାଗଜ଼	/kaːɡɔd͡ʒɔ/
କାଗଜ	/kaːɡɵd͡ʒɵ/
କାଗଜବାଲା	/kaːɡɔd͡ʒɔbaːlaː/
କାଚ	/kaːt͡ʃɔ/
କାଚଗ୍ଲାସ	/kaːt͡ʃɔglaːsɔ/
କାଜରୀ	/kaːd͡ʒɔri/
କାଜୁ	/kaːd͡ʒu/
କାଟି	/kaːʈi/
କାଟିଦେବାକୁ	/kaːʈid̪ebaːku/
କାଟିବାକୁ	/kaːʈibaːku/
କାଟିବାରେ	/kaːʈibaːre/
କାଟିବି	/kaːʈibi/
କାଟୁଛନ୍ତି	/kaːʈut͡ʃʰɔnt̪i/
କାଟୁଥିବାବେଳେ	/kaːʈut̪ʰibaːbel̪e/
କାଟୁଥିଲେ	/kaːʈut̪ʰile/
କାଟେ	/kaːʈe/
କାଟୋ	/kaːʈo/
କାଟୋକୁ	/kaːʈoku/
କାଠ	/kaːʈʰɵ/
କାଠି	/kaːʈʰi/
କାଠିକୁ	/kaːʈʰiku/
କାଠିର	/kaːʈʰiɾɔ/
କାଠିରେ	/kaːʈʰire/
କାଢି	/kaːɖʱi/
କାଢ଼ି	/kaːɽʱi/
କାଢ଼ିକି	/kaːɽʱiki/
କାଢ଼ିବାରେ	/kaːɽʱibaːre/
କାଢ଼ିଲା	/kaːɽʱilaː/
କାଢୁଛି	/kaːɖʱut͡ʃʰi/
କାଦୁଅ	/kaːd̪uɔ/
କାନ	/kaːnɔ/
କାନପାଖେ	/kaːnɔpaːkʰe/
କାନଭାସରେ	/kaːnɔbʱaːsɔre/
କାନର	/kaːnɔɾɔ/
କାନରେ	/kaːnɔre/
କାନାଡାରେ	/kaːnaːɖaːre/
କାନ୍ଥ	/kaːnt̪ʰɔ/
କାନ୍ଥରେ	/kaːnt̪ʰɔre/
କାନ୍ଦ	/kaːnd̪ɔ/
କାନ୍ଦନା	/kaːnd̪ɔnaː/
କାନ୍ଦି	/kaːnd̪i/
କାନ୍ଦିଉଠିଲା	/kaːnd̪iuʈʰilaː/
କାନ୍ଦିକାନ୍ଦି	/kaːnd̪ikaːnd̪i/
କାନ୍ଦିବ	/kaːnd̪ibɔ/
କାନ୍ଦିବାକୁ	/kaːnd̪ibaːku/
କାନ୍ଦିଲା	/kaːnd̪ilaː/
କାନ୍ଦିଲି	/kaːnd̪ili/
କାନ୍ଦୁକାନ୍ଦୁ	/kaːnd̪ukaːnd̪u/
କାନ୍ଦୁଛି	/kaːnd̪ut͡ʃʰi/
କାନ୍ଦୁଥାଏ	/kaːnd̪ut̪ʰaːe/
କାନ୍ଦୁଥିଲା	/kaːnd̪ut̪ʰilaː/
କାନ୍ଦେ	/kaːnd̪e/
କାନ୍ଧ	/kaːnd̪ʱɔ/
କାନ୍ଧଥିଲା	/kaːnd̪ʱɔt̪ʰilaː/
କାନ୍ଧରେ	/kaːnd̪ʱɔre/
କାବା	/kaːbaː/
କାବୁଲର	/kaːbulɔɾɔ/
କାବ୍ୟ	/kaːbjɵ/
କାମ	/kaːmɵ/
କାମକୁ	/kaːmɔku/
କାମଟି	/kaːmɔʈi/
କାମଟେ	/kaːmɔʈe/
କାମରେ	/kaːmɵre/
କାର	/kaːɾɔ/
କାରକ	/kaːɾɔkɔ/
କାରଖାନା	/kaːɾɵkʰaːnaː/
କାରଣ	/kaːɾɵɳɵ/
କାରଣରୁ	/kaːɾɵɳɵru/
କାରୀ	/kaːri/
କାରୁକାର୍ଯ୍ୟଭରା	/kaːrukaːrd͡ʒjɔbʰɔraː/
କାର୍ଟନ୍	/kaːrʈɔn/
କାର୍‌ଟି	/kaːrʈi/
କାର୍ଡରେ	/kaːrɖɔre/
କାର୍ତ୍ତିକ	/kaːrt̪t̪ikɵ/
କାର୍ଯ୍ୟ	/kaːrd͡ʒjɵ/
କାର୍ଯ୍ୟକ୍ରମ	/kaːrd͡ʒjɵkɾɵmɵ/
କାର୍ଯ୍ୟାଳୟ	/kaːrd͡ʒjaːl̪ɔjɔ/
କାଲି	/kaːli/
କାଲିଆ	/kaːliaː/
କାଳ	/kaːl̪ɵ/
କାଳରେ	/kaːl̪ɵre/
କାଳୀ	/kaːl̪i/
କାଳୀନ	/kaːl̪inɔ/
କାଳୁ	/kaːl̪u/
କାଳେ	/kaːl̪e/
କାୱଁ	/kaːuɔ̃/
କାୱଁ-କାୱଁ	/kaːuɔ̃-kaːuɔ̃/
କାଶ	/kaːsɵ/
କାଶି	/kaːsi/
କାଶୁ	/kaːsu/
କାହାକୁ	/kaːhaːku/
କାହାଠୁ	/kaːhaːʈʰu/
କାହାଣୀ	/kaːhaːɳi/
କାହାଣୀଟିଏ	/kaːhaːɳiʈie/
କାହାଣୀଥିବା	/kaːhaːɳit̪ʰibaː/
କାହାନ୍ତି	/kaːhaːnt̪i/
କାହାରି	/kaːhaːri/
କାହାଳୀ	/kaːhaːl̪i/
କାହାଳୀଟି	/kaːhaːl̪iʈi/
କାହିଁ	/kaːhĩ/
କାହିଁକି	/kaːhĩki/
କି	/ki/
କିଏ	/kie/
କିଛି	/kit͡ʃʰi/
କିଛିଟା	/kit͡ʃʰiʈaː/
କିଛିପାଦ	/kit͡ʃʰipaːd̪ɔ/
କିଣ	/kiɳɔ/
କିଣା	/kiɳaː/
କିଣି	/kiɳi/
କିଣିଦେଲେ	/kiɳid̪ele/
କିଣିବା	/kiɳibaː/
କିଣିବାକୁ	/kiɳibaːku/
କିଣିବି	/kiɳibi/
କିଣିଲେ	/kiɳile/
କିଣୁଥିଲେ	/kiɳut̪ʰile/
କିନ୍	/kin/
କିନ୍ତୁ	/kint̪u/
କିପରି	/kipɵri/
କିଭଳି	/kibʰɔl̪i/
କିମି	/kimi/
କିମିତି	/kimit̪i/
କିମ୍ବଦନ୍ତୀ	/kimbɵd̪ɵnt̪i/
କିମ୍ବା	/kimbaː/
କିଲୋ	/kilo/
କିଲୋମିଟର	/kilomiʈɵɾɵ/
କିଶୋର	/kisoɾɵ/
କିସ	/kisɵ/
କିସମିସ୍	/kisɔmis/
କୀଟପତଙ୍ଗ	/kiʈɔpɔt̪ɔŋɡɔ/
କୀରଣ	/kiɾɔɳɔ/
କୁ	/ku/
କୁଆଡ଼େ	/kuaːɽe/
କୁକୁଡ଼ା	/kukuɽaː/
କୁକୁର	/kukuɾɔ/
କୁକୁରକୁ	/kukuɾɔku/
କୁକୁରଟିଏ	/kukuɾɔʈie/
କୁଖ୍ୟାତି	/kukʰjaːt̪i/
କୁଞ୍ଚି	/kuɲt͡ʃi/
କୁଞ୍ଚିଆ	/kuɲt͡ʃiaː/
କୁଟା	/kuʈaː/
କୁଡ଼ିଆ	/kuɽiaː/
କୁଡ଼ିଆକୁ	/kuɽiaːku/
କୁଡ଼ୁମୁଡ଼ି	/kuɽumuɽi/
କୁଣିଆଁ	/kuɳiaː̃/
କୁଣ୍ଡାଇ	/kuɳɖaːi/
କୁଣ୍ଡାଇବା	/kuɳɖaːibaː/
କୁଣ୍ଢାଇ	/kuɳɖʱaːi/
କୁତୁକୁତୁ	/kut̪ukut̪u/
କୁଦାରେ	/kud̪aːre/
କୁନି	/kuni/
କୁନିମାଛ	/kunimaːt͡ʃʰɔ/
କୁମାର	/kumaːɾɵ/
କୁମାରୀ	/kumaːri/
କୁମ୍ଭାର	/kumbʱaːɾɔ/
କୁମ୍ଭାରୁଣୀ	/kumbʱaːruɳi/
କୁମ୍ଭୀର	/kumbʱiɾɔ/
କୁମ୍ଭୀରଙ୍କ	/kumbʱiɾɔŋkɔ/
କୁମ୍ଭୀରଟିଏ	/kumbʱiɾɔʈie/
କୁମ୍ଭୀରଟେ	/kumbʱiɾɔʈe/
କୁମ୍ଭୀରମାନଙ୍କୁ	/kumbʱiɾɔmaːnɔŋku/
କୁମ୍ଭୀରମାନେ	/kumbʱiɾɔmaːne/
କୁଶଳ	/kusɔl̪ɔ/
କୁଶଳତାକୁ	/kusɔl̪ɔt̪aːku/
କୁଶଳୀ	/kusɔl̪i/
କୁସ୍ତି	/kust̪i/
କୁହ	/kuhɔ/
କୁହନ୍ତି	/kuhɔnt̪i/
କୁହା	/kuhaː/
କୁହାଯାଇଥାଏ	/kuhaːd͡ʒaːit̪ʰaːe/
କୁହାଯାଏ	/kuhaːd͡ʒaːe/
କୁହାଯିବ	/kuhaːd͡ʒibɔ/
କୁହୁଡ଼ି	/kuhuɽi/
କୁହେ	/kuhe/
କୂଅଁ	/kuɔ̃/
କୂଅରୁ	/kuɔru/
କୂଳକୁ	/kul̪ɔku/
କୂଳର	/kul̪ɔɾɔ/
କୂଳରେ	/kul̪ɵre/
କୃତି	/krut̪i/
କୃମି	/krumi/
କୃଷକ	/krusɔkɔ/
କୃଷି	/krusi/
କୃଷ୍ଣ	/krusɳɵ/
କୃଷ୍ଣଚନ୍ଦ୍ର	/krusɳɵt͡ʃɵnd̪ɾɵ/
କେ	/ke/
କେଇ	/kei/
କେଉଁ	/keũ/
କେଉଁଠି	/keũʈʰi/
କେକ୍‌	/kek/
କେଜାଣି	/ked͡ʒaːɳi/
କେଡେ	/keɖe/
କେଡ଼େ	/keɽe/
କେତେ	/ket̪e/
କେତେକ	/ket̪ekɵ/
କେତେଗୁଡ଼ିଏ	/ket̪eguɽie/
କେତେଥର	/ket̪et̪ʰɔɾɔ/
କେତେବେଳୁ	/ket̪ebel̪u/
କେତେବେଳେ	/ket̪ebel̪e/
କେତୋଟି	/ket̪oʈi/
କେନ୍ଦୁଝର	/kend̪ud͡ʒʱɵɾɵ/
କେନ୍ଦ୍ର	/kend̪ɾɵ/
କେନ୍ଦ୍ରଶାସିତ	/kend̪ɾɵsaːsit̪ɵ/
କେନ୍ଦ୍ରାପଡ଼ା	/kend̪raːpɵɽaː/
କେଫେନ୍	/kepʰen/
କେବଳ	/kebɵl̪ɵ/
କେବେ	/kebe/
କେବେକେବେ	/kebekebe/
କେବେବି	/kebebi/
କେବେହେଲେ	/kebehele/
କେମିତି	/kemit̪i/
କେମ୍ପିଙ୍ଗ	/kempiŋɡɔ/
କେରଳ	/keɾɵl̪ɵ/
କେଳୁଚରଣ	/kel̪ut͡ʃɵɾɵɳɵ/
କେଶର	/kesɔɾɔ/
କେଶରୀ	/kesɵri/
କେସର	/kesɔɾɔ/
କେହି	/kehi/
କୋଇଲା	/koilaː/
କୋଇଲି	/koili/
କୋଉ	/kou/
କୋଉଠି	/kouʈʰi/
କୋଉଠୁ	/kouʈʰu/
କୋଙ୍କଣୀ	/koŋkɵɳi/
କୋଟି	/koʈi/
କୋଟ୍	/koʈ/
କୋଠରୀ	/koʈʰɔri/
କୋଠା	/koʈʰaː/
କୋଡ଼	/koɖɵ/
କୋଡ଼ିଏ	/koɽie/
କୋଣ	/koɳɔ/
କୋଣକୁ	/koɳɔku/
କୋଣରେ	/koɳɔre/
କୋଣାର୍କ	/koɳaːrkɵ/
କୋଣିଆ	/koɳiaː/
କୋତରା	/kot̪ɔraː/
କୋବି	/kobi/
କୋମଳ	/komɔl̪ɔ/
କୋରମା	/koɾɔmaː/
କୋରାପୁଟ	/koraːpuʈɵ/
କୋର୍ଟ	/korʈɔ/
କୋର୍ଟକୁ	/korʈɔku/
କୋର୍ଟଟି	/korʈɔʈi/
କୋଲମ୍	/kolɔm/
କୋଳ	/kol̪ɔ/
କୋଳରେ	/kol̪ɔre/
କୋଳି	/kol̪i/
କୋଳେଇ	/kol̪ei/
କୋଷ	/kosɵ/
କୌଣସି	/kouɳɵsi/
କୌତୁକିଆ	/kɔut̪ukiaː/
କୌଶିକ	/kɔusikɔ/
କ୍ୟାଣ୍ଡିର	/kjaːɳɖiɾɔ/
କ୍ରମରେ	/kɾɔmɔre/
କ୍ରମାଙ୍କ	/kɾɵmaːŋkɵ/
କ୍ରମିକ	/kɾɵmikɵ/
କ୍ରମେ	/kɾɵme/
କ୍ରିକେଟ	/krikeʈɵ/
କ୍ରିକେଟ୍	/krikeʈ/
କ୍ରିୟା	/krijaː/
କ୍ରୀକ୍	/krik/
କ୍ରେଟାସିଅସ	/kreʈaːsiɵsɵ/
କ୍ଲାସରୁମ	/klaːsɔrumɔ/
କ୍ଲାସରେ	/klaːsɔre/
କ୍ଲିକ	/klikɵ/
କ୍ଳାନ୍ତ	/kl̪aːnt̪ɔ/
କ୍ଷଣକ	/kʰjɔɳɔkɔ/
କ୍ଷଣି	/kʰjɔɳi/
କ୍ଷତ	/kʰjɵt̪ɵ/
କ୍ଷତି	/kʰjɔt̪i/
କ୍ଷତିକାରକ	/kʰjɔt̪ikaːɾɔkɔ/
କ୍ଷମତା	/kʰjɵmɵt̪aː/
କ୍ଷୟ	/kʰjɵjɵ/
କ୍ଷୀର	/kʰiɾɵ/
କ୍ଷୀରି	/kʰiri/
କ୍ଷୁଦ୍ର	/kʰjud̪ɾɵ/
କ୍ଷେତ୍ର	/kʰet̪ɾɵ/
କ୍ଷେତ୍ରରେ	/kʰet̪ɾɵre/
ଖଂଜିତ	/kʰɔŋd͡ʒit̪ɔ/
ଖଞା	/kʰɔɲaː/
ଖଞ୍ଜି	/kʰɔɲd͡ʒi/
ଖଞ୍ଜିବା	/kʰɔɲd͡ʒibaː/
ଖଞ୍ଜିବାରେ	/kʰɔɲd͡ʒibaːre/
ଖଞ୍ଜିଲା	/kʰɔɲd͡ʒilaː/
ଖଞ୍ଜେ	/kʰɔɲd͡ʒe/
ଖଟ	/kʰɔʈɔ/
ଖଟରେ	/kʰɔʈɔre/
ଖଟା	/kʰɔʈaː/
ଖଣ୍ଡ	/kʰɵɳɖɵ/
ଖଣ୍ଡା	/kʰɔɳɖaː/
ଖଣ୍ଡାୟତ	/kʰɔɳɖaːjɔt̪ɔ/
ଖଣ୍ଡିଆ	/kʰɔɳɖiaː/
ଖଣ୍ଡିଏ	/kʰɔɳɖie/
ଖଣ୍ଡିକୁ	/kʰɔɳɖiku/
ଖଣ୍ଡେ	/kʰɔɳɖe/
ଖବର	/kʰɵbɵɾɵ/
ଖବରକାଗଜ	/kʰɵbɵɾɵkaːɡɵd͡ʒɵ/
ଖମ୍ବ	/kʰɔmbɔ/
ଖରଣାଟି	/kʰɔɾɔɳaːʈi/
ଖରା	/kʰɔraː/
ଖରାଦିନ	/kʰɔraːd̪inɔ/
ଖରାଦିନିଆ	/kʰɔraːd̪iniaː/
ଖରାଦିନେ	/kʰɔraːd̪ine/
ଖରାପ	/kʰɔraːpɔ/
ଖରାପଡୁଥିବା	/kʰɔraːpɔɖut̪ʰibaː/
ଖରାପ୍	/kʰɔraːp/
ଖରାରେ	/kʰɔraːre/
ଖର୍ଚ୍ଚ	/kʰɵrt͡ʃt͡ʃɵ/
ଖସି	/kʰɔsi/
ଖହିଲା	/kʰɔhilaː/
ଖାଁ	/kʰaː̃/
ଖାଆନ୍ତି	/kʰaːaːnt̪i/
ଖାଇ	/kʰaːi/
ଖାଇକି	/kʰaːiki/
ଖାଇଥାନ୍ତି	/kʰaːit̪ʰaːnt̪i/
ଖାଇଦେଲା	/kʰaːid̪elaː/
ଖାଇନୁ	/kʰaːinu/
ଖାଇପକେଇଲା	/kʰaːipɔkeilaː/
ଖାଇପାରିବନି	/kʰaːipaːribɔni/
ଖାଇବ	/kʰaːibɔ/
ଖାଇବା	/kʰaːibaː/
ଖାଇବାକୁ	/kʰaːibaːku/
ଖାଇବାଠାରୁ	/kʰaːibaːʈʰaːru/
ଖାଇବାର	/kʰaːibaːɾɔ/
ଖାଇବି	/kʰaːibi/
ଖାଇବିନି	/kʰaːibini/
ଖାଇବୁ	/kʰaːibu/
ଖାଇଲା	/kʰaːilaː/
ଖାଇଲାନି	/kʰaːilaːni/
ଖାଇଲିନି	/kʰaːilini/
ଖାଇଲେ	/kʰaːile/
ଖାଉ	/kʰaːu/
ଖାଉଖାଉ	/kʰaːukʰaːu/
ଖାଉଛନ୍ତି	/kʰaːut͡ʃʰɔnt̪i/
ଖାଉଛି	/kʰaːut͡ʃʰi/
ଖାଉଥିଲେ	/kʰaːut̪ʰile/
ଖାଉନୁ	/kʰaːunu/
ଖାଏ	/kʰaːe/
ଖାତା	/kʰaːt̪aː/
ଖାତାକୁ	/kʰaːt̪aːku/
ଖାତାରୁ	/kʰaːt̪aːru/
ଖାତିର	/kʰaːt̪iɾɔ/
ଖାତିର୍	/kʰaːt̪ir/
ଖାଦ୍ୟ	/kʰaːd̪jɵ/
ଖାଦ୍ୟମଧ୍ୟରୁ	/kʰaːd̪jɔmɔd̪ʱjɔru/
ଖାନ୍	/kʰaːn/
ଖାବରା	/kʰaːbɔraː/
ଖାଲି	/kʰaːli/
ଖାଲିବସ୍ତା	/kʰaːlibɔst̪aː/
ଖିଅର	/kʰiɔɾɔ/
ଖିରି	/kʰiri/
ଖିଲାଣକରା	/kʰilaːɳɔkɔraː/
ଖିଲାବି	/kʰilaːbi/
ଖୁଆଇ	/kʰuaːi/
ଖୁଆଇବାକୁ	/kʰuaːibaːku/
ଖୁଣ୍ଟରେ	/kʰuɳʈɔre/
ଖୁବ	/kʰubɵ/
ଖୁବ୍	/kʰub/
ଖୁବ୍‌	/kʰub/
ଖୁସି	/kʰusi/
ଖୁସିରେ	/kʰusire/
ଖୁସୀରେ	/kʰusire/
ଖେଳ	/kʰel̪ɵ/
ଖେଳଣା	/kʰel̪ɔɳaː/
ଖେଳନ୍ତି	/kʰel̪ɔnt̪i/
ଖେଳରେ	/kʰel̪ɔre/
ଖେଳାଳି	/kʰel̪aːl̪i/
ଖେଳାଳୀ	/kʰel̪aːl̪i/
ଖେଳି	/kʰel̪i/
ଖେଳିବା	/kʰel̪ibaː/
ଖେଳିବାକୁ	/kʰel̪ibaːku/
ଖେଳିବି	/kʰel̪ibi/
ଖେଳିବୁ	/kʰel̪ibu/
ଖେଳୁ	/kʰel̪u/
ଖେଳୁଛନ୍ତି	/kʰel̪ut͡ʃʰɔnt̪i/
ଖେଳୁଥିବା	/kʰel̪ut̪ʰibaː/
ଖେଳେ	/kʰel̪e/
ଖୋଇସାରି	/kʰoisaːri/
ଖୋଜ	/kʰod͡ʒɔ/
ଖୋଜନ୍ତି	/kʰod͡ʒɔnt̪i/
ଖୋଜନ୍ତୁ	/kʰod͡ʒɔnt̪u/
ଖୋଜାଗିରି	/kʰod͡ʒaːgiri/
ଖୋଜି	/kʰod͡ʒi/
ଖୋଜିବା	/kʰod͡ʒibaː/
ଖୋଜିବାକୁ	/kʰod͡ʒibaːku/
ଖୋଜିଲି	/kʰod͡ʒili/
ଖୋଜିଲେ	/kʰod͡ʒile/
ଖୋଜୁ	/kʰod͡ʒu/
ଖୋଜୁଛ	/kʰod͡ʒut͡ʃʰɔ/
ଖୋଜୁଛି	/kʰod͡ʒut͡ʃʰi/
ଖୋଦେଇ	/kʰod̪ei/
ଖୋର୍ଦ୍ଧା	/kʰord̪d̪ʱaː/
ଖୋଲ	/kʰolɔ/
ଖୋଲା	/kʰolaː/
ଖୋଲାପଟ	/kʰolaːpɔʈɔ/
ଖୋଲାରେ	/kʰolaːre/
ଖୋଲି	/kʰoli/
ଖୋଲିଦିଅ	/kʰolid̪iɔ/
ଖୋଲିଦେଇ	/kʰolid̪ei/
ଖୋଲିଦେଖିଲା	/kʰolid̪ekʰilaː/
ଖୋଲିଦେଲା	/kʰolid̪elaː/
ଖୋଲିଦେଲେ	/kʰolid̪ele/
ଖୋଲିବାକୁ	/kʰolibaːku/
ଖୋଲିବି	/kʰolibi/
ଖୋଲିଲା	/kʰolilaː/
ଖୋଲିଲେ	/kʰolile/
ଖୋଳିବା	/kʰol̪ibaː/
ଖୋଳିଲୁ	/kʰol̪ilu/
ଖୋଳୁଛି	/kʰol̪ut͡ʃʰi/
ଖୋଳୁଥିଲା	/kʰol̪ut̪ʰilaː/
ଖୋସି	/kʰosi/
ଖ୍ରୀ	/kʰri/
ଖ୍ରୀଷ୍ଟ	/kʰrisʈɵ/
ଖ୍ରୀଷ୍ଟପୂର୍ବ	/kʰrisʈɵpurbɵ/
ଖ୍ରୀଷ୍ଟାବ୍ଦରେ	/kʰrisʈaːbd̪ɵre/
ଖ୍ୱାବଗାହ୍	/kʰuaːbɔgaːh/
ଗଙ୍ଗା	/ɡɵŋgaː/
ଗଙ୍ଗାଧର	/ɡɵŋgaːd̪ʱɵɾɵ/
ଗଚ୍ଛ	/ɡɔt͡ʃt͡ʃʰɔ/
ଗଛ	/ɡɵt͡ʃʰɵ/
ଗଛକୁ	/ɡɔt͡ʃʰɔku/
ଗଛଟିଏ	/ɡɔt͡ʃʰɔʈie/
ଗଛତଳେ	/ɡɔt͡ʃʰɔt̪ɔl̪e/
ଗଛମାନଙ୍କ	/ɡɔt͡ʃʰɔmaːnɔŋkɔ/
ଗଛମୂଳେ	/ɡɔt͡ʃʰɔmul̪e/
ଗଛର	/ɡɵt͡ʃʰɵɾɵ/
ଗଛରୁ	/ɡɔt͡ʃʰɔru/
ଗଛରେ	/ɡɔt͡ʃʰɔre/
ଗଜପତି	/ɡɵd͡ʒɵpɵt̪i/
ଗଞ୍ଜାମ	/ɡɵɲd͡ʒaːmɵ/
ଗଠନ	/ɡɵʈʰɵnɵ/
ଗଠିତ	/ɡɵʈʰit̪ɵ/
ଗଡ଼ଗଡ଼	/ɡɔɽɔɡɔɽɔ/
ଗଡ଼ାଣିରେ	/ɡɔɽaːɳire/
ଗଡି	/ɡɔɖi/
ଗଡ଼ି	/ɡɔɽi/
ଗଡିପଡିଲା	/ɡɔɖipɔɖilaː/
ଗଢ଼ଣଟି	/ɡɔɽʱɔɳɔʈi/
ଗଢିବାରେ	/ɡɔɖʱibaːre/
ଗଣ	/ɡɵɳɵ/
ଗଣତି	/ɡɔɳɔt̪i/
ଗଣତିର	/ɡɔɳɔt̪iɾɔ/
ଗଣନା	/ɡɵɳɵnaː/
ଗଣିତ	/ɡɵɳit̪ɵ/
ଗଣିତରେ	/ɡɔɳit̪ɔre/
ଗଣିବାକୁ	/ɡɔɳibaːku/
ଗଣିଲା	/ɡɔɳilaː/
ଗଣେଶ	/ɡɵɳesɵ/
ଗଣ୍ଠଲି	/ɡɔɳʈʰɔli/
ଗଣ୍ଠି	/ɡɵɳʈʰi/
ଗଣ୍ଠିର	/ɡɔɳʈʰiɾɔ/
ଗତ	/ɡɵt̪ɵ/
ଗତକାଲି	/ɡɔt̪ɔkaːli/
ଗତି	/ɡɵt̪i/
ଗତିକୁ	/ɡɔt̪iku/
ଗଦ	/ɡɔd̪ɔ/
ଗଦା	/ɡɔd̪aː/
ଗଧ	/ɡɔd̪ʱɔ/
ଗଧିଆ	/ɡɔd̪ʱiaː/
ଗଧିଆଙ୍କୁ	/ɡɔd̪ʱiaːŋku/
ଗଧିଆମାନେ	/ɡɔd̪ʱiaːmaːne/
ଗଧିଆର	/ɡɔd̪ʱiaːɾɔ/
ଗପ	/ɡɵpɵ/
ଗପବହି	/ɡɔpɔbɔhi/
ଗପସପ	/ɡɔpɔsɔpɔ/
ଗପ୍ପୁ	/ɡɔppu/
ଗପ୍ପୁକୁ	/ɡɔppuku/
ଗବେଷଣା	/ɡɵbesɵɳaː/
ଗଭୀର	/ɡɔbʱiɾɔ/
ଗଭୀରକୁ	/ɡɔbʱiɾɔku/
ଗମନାଗମନ	/ɡɵmɵnaːɡɵmɵnɵ/
ଗରମ	/ɡɵɾɵmɵ/
ଗରମ-ଗରମ	/ɡɔɾɔmɔ-ɡɔɾɔmɔ/
ଗରମ୍	/ɡɔɾɔm/
ଗରିବ	/ɡɔribɔ/
ଗର୍ଜନ	/ɡɔrd͡ʒɔnɔ/
ଗର୍ତ୍ତ	/ɡɔrt̪t̪ɔ/
ଗର୍ବ	/ɡɔrbɔ/
ଗର୍ବର	/ɡɔrbɔɾɔ/
ଗର୍ବରେ	/ɡɔrbɔre/
ଗର୍ବିତ	/ɡɔrbit̪ɔ/
ଗର୍ଭ	/ɡɵrbʰɵ/
ଗଲା	/ɡɔlaː/
ଗଲାଇମ୍ମା	/ɡɔlaːimmaː/
ଗଲାଣି	/ɡɔlaːɳi/
ଗଲାନି	/ɡɔlaːni/
ଗଲାବେଳକୁ	/ɡɔlaːbel̪ɔku/
ଗଲାବେଳେ	/ɡɔlaːbel̪e/
ଗଲି	/ɡɔli/
ଗଲୁ	/ɡɔlu/
ଗଲେ	/ɡɵle/
ଗଳା	/ɡɔl̪aː/
ଗଳି	/ɡɔl̪i/
ଗଳିପଡ଼ିଲା	/ɡɔl̪ipɔɽilaː/
ଗଳିରେ	/ɡɔl̪ire/
ଗଳ୍ପ	/ɡɵl̪pɵ/
ଗହଣା	/ɡɔhɔɳaː/
ଗହମ	/ɡɔhɔmɔ/
ଗାଁ	/gaː̃/
ଗାଆଁ	/gaːaː̃/
ଗାଆଁଟି	/gaːaː̃ʈi/
ଗାଆଁଠାରୁ	/gaːaː̃ʈʰaːru/
ଗାଇ	/gaːi/
ଗାଇପାରୁଥିବ	/gaːipaːrut̪ʰibɔ/
ଗାଇବାକୁ	/gaːibaːku/
ଗାଇଲା	/gaːilaː/
ଗାଈ	/gaːi/
ଗାଈଟି	/gaːiʈi/
ଗାଈଟିଏ	/gaːiʈie/
ଗାଈମାନଙ୍କୁ	/gaːimaːnɔŋku/
ଗାଉଛନ୍ତି	/gaːut͡ʃʰɔnt̪i/
ଗାଉଛି	/gaːut͡ʃʰi/
ଗାଏ	/gaːe/
ଗାଜର	/gaːd͡ʒɔɾɔ/
ଗାଡ଼ିଆରେ	/gaːɽiaːre/
ଗାଢ	/gaːɖʱɔ/
ଗାଢ଼	/gaːɽʱɔ/
ଗାଢରଙ୍ଗର	/gaːɖʱɔɾɔŋɡɔɾɔ/
ଗାତ	/gaːt̪ɔ/
ଗାଧୋଇ	/gaːd̪ʱoi/
ଗାନ	/gaːnɵ/
ଗାନ୍ଧି	/gaːnd̪ʱi/
ଗାନ୍ଧିଜୀ	/gaːnd̪ʱid͡ʒi/
ଗାନ୍ଧିଜୀଙ୍କ	/gaːnd̪ʱid͡ʒiŋkɔ/
ଗାନ୍ଧିଜୀଙ୍କୁ	/gaːnd̪ʱid͡ʒiŋku/
ଗାନ୍ଧୀ	/gaːnd̪ʱi/
ଗାନ୍ଧୀଜୀ	/gaːnd̪ʱid͡ʒi/
ଗାନ୍ଧୀଜୀଙ୍କ	/gaːnd̪ʱid͡ʒiŋkɔ/
ଗାୟକ	/gaːjɵkɵ/
ଗାର	/gaːɾɔ/
ଗାଁରେ	/gaː̃re/
ଗାରୋ	/gaːro/
ଗାଲ	/gaːlɔ/
ଗାଲରେ	/gaːlɔre/
ଗାଲିଚା	/gaːlit͡ʃaː/
ଗାଲିଚାଠାରୁ	/gaːlit͡ʃaːʈʰaːru/
ଗାଳି	/gaːl̪i/
ଗାଳ୍ପିକ	/gaːl̪pikɵ/
ଗିନା	/ginaː/
ଗିରଫ୍	/giɾɔpʰ/
ଗିଳି	/gil̪i/
ଗୀତ	/git̪ɵ/
ଗୀତା	/git̪aː/
ଗୀତିକାର	/git̪ikaːɾɵ/
ଗୁଜରାଟ	/gud͡ʒɵraːʈɵ/
ଗୁଜରାଟୀ	/gud͡ʒɵraːʈi/
ଗୁଜରାତ	/gud͡ʒɔraːt̪ɔ/
ଗୁଜୁରାଟ	/gud͡ʒuraːʈɔ/
ଗୁଡ଼	/guɽɔ/
ଗୁଡାଏ	/guɖaːe/
ଗୁଡ଼ାକ	/guɽaːkɔ/
ଗୁଡ଼ି	/guɽi/
ଗୁଡିଏ	/guɖie/
ଗୁଡ଼ିଏ	/guɽie/
ଗୁଡିକ	/guɖikɵ/
ଗୁଡ଼ିକ	/guɽikɔ/
ଗୁଡ଼ିକ	/guɽikɵ/
ଗୁଡିକର	/guɖikɔɾɔ/
ଗୁଡ଼ିକର	/guɽikɵɾɵ/
ଗୁଡିକୁ	/guɖiku/
ଗୁଡ଼ିକୁ	/guɽiku/
ଗୁଡ଼ିରେ	/guɽire/
ଗୁଡୁମ	/guɖumɔ/
ଗୁଡ଼େଇ	/guɽei/
ଗୁଣ	/guɳɵ/
ଗୁଣନ	/guɳɔnɔ/
ଗୁଣା	/guɳaː/
ଗୁଣି	/guɳi/
ଗୁଣୁଗୁଣୁ	/guɳuguɳu/
ଗୁଣେ	/guɳe/
ଗୁଣ୍ଡ	/guɳɖɔ/
ଗୁଣ୍ଡିଚା	/guɳɖit͡ʃaː/
ଗୁଣ୍ଡୁଚି	/guɳɖut͡ʃi/
ଗୁପ୍ତଚର	/gupt̪ɔt͡ʃɔɾɔ/
ଗୁମୁରୁଥିଲେ	/gumurut̪ʰile/
ଗୁମ୍ପା	/gumpaː/
ଗୁମ୍ଫା	/gumpʰaː/
ଗୁରୁ	/guru/
ଗୁରୁବାର	/gurubaːɾɵ/
ଗୁର୍ରର୍ରର୍ର	/gurɾɔrɾɔrɾɔ/
ଗୁଲି	/guli/
ଗୁଲିର	/guliɾɔ/
ଗୁଲ୍	/gul/
ଗୁଳି	/gul̪i/
ଗୁଳ୍ମ	/gul̪mɵ/
ଗୁହାରୀ	/guhaːri/
ଗୁହାଳ	/guhaːl̪ɔ/
ଗେଟ୍	/geʈ/
ଗେଣ୍ତା	/geɳt̪aː/
ଗେରୁଆ	/geruaː/
ଗେଲ୍ହା	/gelhaː/
ଗୋଇଠା	/goiʈʰaː/
ଗୋଇନ୍ଦା	/goind̪aː/
ଗୋଟାଇ	/goʈaːi/
ଗୋଟାଇବା	/goʈaːibaː/
ଗୋଟାଏ	/goʈaːe/
ଗୋଟି	/goʈi/
ଗୋଟିଏ	/goʈie/
ଗୋଟେ	/goʈe/
ଗୋଟେଇ	/goʈei/
ଗୋଡ	/goɖɔ/
ଗୋଡ଼	/goɽɔ/
ଗୋଡରେ	/goɖɔre/
ଗୋଡ଼ରେ	/goɽɔre/
ଗୋଡ଼ାଇବାକୁ	/goɽaːibaːku/
ଗୋଡ଼ି	/goɽi/
ଗୋତେ	/got̪e/
ଗୋଧୁଳୀ	/god̪ʱul̪i/
ଗୋପବନ୍ଧୁ	/gopɵbɵnd̪ʱu/
ଗୋପାଳ	/gopaːl̪ɵ/
ଗୋପାଳପୁର	/gopaːl̪ɵpuɾɵ/
ଗୋପୀନାଥ	/gopinaːt̪ʰɵ/
ଗୋବର	/gobɔɾɔ/
ଗୋବିନ୍ଦ	/gobind̪ɵ/
ଗୋଲ	/golɵ/
ଗୋଲ-ଗୋଲ	/golɔ-golɔ/
ଗୋଲକ	/golɔkɔ/
ଗୋଲମରିଚ	/golɔmɔrit͡ʃɔ/
ଗୋଲାପ	/golaːpɵ/
ଗୋଲାପଜାମୁ	/golaːpɔd͡ʒaːmu/
ଗୋଲାପି	/golaːpi/
ଗୋଲାମୁଣ୍ଡା	/golaːmuɳɖaː/
ଗୋଲୁ	/golu/
ଗୋଲୁର	/goluɾɔ/
ଗୋଲୁରେ	/golure/
ଗୋଲେଇ	/golei/
ଗୋଲ୍	/gol/
ଗୋଳା	/gol̪aː/
ଗୌରୀ	/gouri/
ଗ୍ରନ୍ଥ	/gɾɵnt̪ʰɵ/
ଗ୍ରହ	/gɾɵhɵ/
ଗ୍ରହଣ	/gɾɵhɵɳɵ/
ଗ୍ରାମ	/graːmɵ/
ଗ୍ରାମର	/graːmɵɾɵ/
ଗ୍ରାମରେ	/graːmɵre/
ଗ୍ରୀକ	/grikɵ/
ଗ୍ରୀଷ୍ମ	/grismɔ/
ଗ୍ରେଗୋରି	/gregori/
ଗ୍ଲାସ	/glaːsɔ/
ଘଟଣା	/ɡʱɵʈɵɳaː/
ଘଟଣାବଳୀ	/ɡʱɵʈɵɳaːbɵl̪i/
ଘଡ଼	/ɡʱɔɽɔ/
ଘଡ଼ଘଡ଼ି	/ɡʱɔɽɔɡʱɔɽi/
ଘଡ଼ି	/ɡʱɔɽi/
ଘଣ୍ଟା	/ɡʱɵɳʈaː/
ଘଣ୍ଟାଟିଏ	/ɡʱɔɳʈaːʈie/
ଘଣ୍ଟି	/ɡʱɔɳʈi/
ଘଣ୍ଟିଟିଏ	/ɡʱɔɳʈiʈie/
ଘନ	/ɡʱɔnɔ/
ଘର	/ɡʱɵɾɵ/
ଘରକୁ	/ɡʱɵɾɵku/
ଘରଟି	/ɡʱɔɾɔʈi/
ଘରଟିଏ	/ɡʱɔɾɔʈie/
ଘରଠୁ	/ɡʱɔɾɔʈʰu/
ଘରର	/ɡʱɔɾɔɾɔ/
ଘରୁ	/ɡʱɔru/
ଘରେ	/ɡʱɵre/
ଘଷା	/ɡʱɔsaː/
ଘଷି	/ɡʱɔsi/
ଘଷିବା	/ɡʱɔsibaː/
ଘଷିବାକୁ	/ɡʱɔsibaːku/
ଘଷୁଥିଲେ	/ɡʱɔsut̪ʰile/
ଘାସ	/gʰaːsɔ/
ଘାସଠୁ	/gʰaːsɔʈʰu/
ଘିଅ	/gʰiɵ/
ଘୁଞ୍ଚାଇଦିଆଗଲା	/gʰuɲt͡ʃaːid̪iaːɡɵlaː/
ଘୁଞ୍ଚାଇଲେ	/gʰuɲt͡ʃaːile/
ଘୁଞ୍ଚାଗଲା	/gʰuɲt͡ʃaːɡɵlaː/
ଘୁଞ୍ଚିବା	/gʰuɲt͡ʃibaː/
ଘୁଡୁ	/gʰuɖu/
ଘୁରି	/gʰuri/
ଘୁରୁଥିଲା	/gʰurut̪ʰilaː/
ଘେରା	/gʰeraː/
ଘେରି	/gʰeri/
ଘୋଡଣୀ	/gʰoɖɔɳi/
ଘୋଡଣୀଟିକୁ	/gʰoɖɔɳiʈiku/
ଘୋଡା	/gʰoɖaː/
ଘୋଡ଼ା	/gʰoɽaː/
ଘୋଡାଇ	/gʰoɖaːi/
ଘୋଡ଼ାଇ	/gʰoɽaːi/
ଘୋଡାକୁ	/gʰoɖaːku/
ଘୋଡାଟିଏ	/gʰoɖaːʈie/
ଘୋଡାଟିକୁ	/gʰoɖaːʈiku/
ଘୋଡାରୁ	/gʰoɖaːru/
ଘୋଡାରେ	/gʰoɖaːre/
ଘୋଡେଇ	/gʰoɖei/
ଘୋଷ	/gʰosɵ/
ଘୋଷଣା	/gʰosɵɳaː/
ଘୋଷାରି	/gʰosaːri/
ଙ୍କ	/ŋkɵ/
ଙ୍କଠାରୁ	/ŋkɔʈʰaːru/
ଙ୍କର	/ŋkɵɾɵ/
ଙ୍କୁ	/ŋku/
ଚଉଡ଼ା	/t͡ʃɔuɽaː/
ଚଉତିଶା	/t͡ʃɵut̪isaː/
ଚକମକିଆ	/t͡ʃɔkɔmɔkiaː/
ଚକାମାରି	/t͡ʃɔkaːmaːri/
ଚକ୍‌	/t͡ʃɔk/
ଚକ୍	/t͡ʃɔk/
ଚକ୍‌ଚକ୍‌	/t͡ʃɔkt͡ʃɔk/
ଚକ୍ର	/t͡ʃɵkɾɵ/
ଚଂଚଳ	/t͡ʃɔŋt͡ʃɔl̪ɔ/
ଚଟାଇ	/t͡ʃɔʈaːi/
ଚଟାଣ	/t͡ʃɔʈaːɳɔ/
ଚଢନ୍ତି	/t͡ʃɔɖʱɔnt̪i/
ଚଢି	/t͡ʃɔɖʱi/
ଚଢ଼ି	/t͡ʃɔɽʱi/
ଚଢ଼ିଗଲା	/t͡ʃɔɽʱiɡɔlaː/
ଚଢ଼ିଗଲୁ	/t͡ʃɔɽʱiɡɔlu/
ଚଢିବା	/t͡ʃɔɖʱibaː/
ଚଢ଼ିବା	/t͡ʃɔɽʱibaː/
ଚଢ଼ିବାକୁ	/t͡ʃɔɽʱibaːku/
ଚଢ଼ିବି	/t͡ʃɔɽʱibi/
ଚଢ଼ିଲେ	/t͡ʃɔɽʱile/
ଚଢ଼େଇ	/t͡ʃɔɽʱei/
ଚଢ଼େଇଟି	/t͡ʃɔɽʱeiʈi/
ଚଢ଼େଇଟିଏ	/t͡ʃɔɽʱeiʈie/
ଚଢ଼େଇମାନେ	/t͡ʃɔɽʱeimaːne/
ଚତୁର୍ଥ	/t͡ʃɵt̪urt̪ʰɵ/
ଚତୁର୍ଥୀ	/t͡ʃɵt̪urt̪ʰi/
ଚତୁର୍ଦ୍ଦଶୀ	/t͡ʃɵt̪urd̪d̪ɵsi/
ଚତୁର୍ଭୁଜ	/t͡ʃɔt̪urbʱud͡ʒɔ/
ଚନ୍ଦନ	/t͡ʃɵnd̪ɵnɵ/
ଚନ୍ଦ୍ର	/t͡ʃɵnd̪ɾɵ/
ଚନ୍ଦ୍ରଶେଖର	/t͡ʃɵnd̪ɾɵsekʰɵɾɵ/
ଚନ୍ଦ୍ରହୀନ	/t͡ʃɔnd̪ɾɔhinɔ/
ଚପଲ	/t͡ʃɔpɔlɔ/
ଚମକ	/t͡ʃɔmɔkɔ/
ଚମକି	/t͡ʃɔmɔki/
ଚମକିବାକୁ	/t͡ʃɔmɔkibaːku/
ଚମକୁ	/t͡ʃɔmɔku/
ଚମଡ଼ା	/t͡ʃɔmɔɽaː/
ଚରଖା	/t͡ʃɔɾɔkʰaː/
ଚରଖାରେ	/t͡ʃɔɾɔkʰaːre/
ଚରଣ	/t͡ʃɵɾɵɳɵ/
ଚରିତ୍ର	/t͡ʃɵrit̪ɾɵ/
ଚର୍ମ	/t͡ʃɵrmɵ/
ଚଲାଇବା	/t͡ʃɔlaːibaː/
ଚଲାନ୍ତି	/t͡ʃɔlaːnt̪i/
ଚଳ	/t͡ʃɔl̪ɔ/
ଚଳଚିତ୍ର	/t͡ʃɵl̪ɵt͡ʃit̪ɾɵ/
ଚଳଚ୍ଚିତ୍ର	/t͡ʃɵl̪ɵt͡ʃt͡ʃit̪ɾɵ/
ଚଳଣି	/t͡ʃɵl̪ɵɳi/
ଚଳାଇ	/t͡ʃɔl̪aːi/
ଚଳିବାକୁ	/t͡ʃɔl̪ibaːku/
ଚଷମା	/t͡ʃɔsɔmaː/
ଚଷମାଟି	/t͡ʃɔsɔmaːʈi/
ଚଷମାରେ	/t͡ʃɔsɔmaːre/
ଚା	/t͡ʃaː/
ଚାଉଳ	/t͡ʃaːul̪ɵ/
ଚାଉଳ-ଚୁନାରୁ	/t͡ʃaːul̪ɔ-t͡ʃunaːru/
ଚାକିରି	/t͡ʃaːkiri/
ଚାଖି	/t͡ʃaːkʰi/
ଚାଚା	/t͡ʃaːt͡ʃaː/
ଚାଚାଙ୍କୁ	/t͡ʃaːt͡ʃaːŋku/
ଚାଟସଭା	/t͡ʃaːʈɵsɵbʱaː/
ଚାଟୁ	/t͡ʃaːʈu/
ଚାଦର	/t͡ʃaːd̪ɔɾɔ/
ଚାନ୍ଦୁଆ	/t͡ʃaːnd̪uaː/
ଚାନ୍ଦୁଆତଳେ	/t͡ʃaːnd̪uaːt̪ɔl̪e/
ଚାପ	/t͡ʃaːpɵ/
ଚାପି	/t͡ʃaːpi/
ଚାପୁଡ଼ାଟିଏ	/t͡ʃaːpuɽaːʈie/
ଚାବି	/t͡ʃaːbi/
ଚାମଚ	/t͡ʃaːmɔt͡ʃɔ/
ଚାମଚରେ	/t͡ʃaːmɔt͡ʃɔre/
ଚାରା	/t͡ʃaːraː/
ଚାରି	/t͡ʃaːri/
ଚାରିଆଡ	/t͡ʃaːriaːɖɔ/
ଚାରିଆଡ଼କୁ	/t͡ʃaːriaːɽɔku/
ଚାରିଆଡ଼େ	/t͡ʃaːriaːɽe/
ଚାରିକୋଣିଆ	/t͡ʃaːrikoɳiaː/
ଚାରିଟା	/t͡ʃaːriʈaː/
ଚାରିଟାକୁ	/t͡ʃaːriʈaːku/
ଚାରିଦିଗେ	/t͡ʃaːrid̪ige/
ଚାରିପଟେ	/t͡ʃaːripɔʈe/
ଚାରିପାଖ	/t͡ʃaːripaːkʰɔ/
ଚାରିବର୍ଷର	/t͡ʃaːribɔrsɔɾɔ/
ଚାଲ	/t͡ʃaːlɔ/
ଚାଲନ୍ତି	/t͡ʃaːlɔnt̪i/
ଚାଲାକ୍‌	/t͡ʃaːlaːk/
ଚାଲାକ୍	/t͡ʃaːlaːk/
ଚାଲି	/t͡ʃaːli/
ଚାଲିକି	/t͡ʃaːliki/
ଚାଲିଗଲା	/t͡ʃaːliɡɔlaː/
ଚାଲିଗଲେ	/t͡ʃaːliɡɔle/
ଚାଲିଚାଲି	/t͡ʃaːlit͡ʃaːli/
ଚାଲିଛ	/t͡ʃaːlit͡ʃʰɔ/
ଚାଲିଛି	/t͡ʃaːlit͡ʃʰi/
ଚାଲିଥାଏ	/t͡ʃaːlit̪ʰaːe/
ଚାଲିପାରିବେନି	/t͡ʃaːlipaːribeni/
ଚାଲିପାରେ	/t͡ʃaːlipaːre/
ଚାଲିବାକୁ	/t͡ʃaːlibaːku/
ଚାଲିବାରେ	/t͡ʃaːlibaːre/
ଚାଲିଯାଇଛନ୍ତି	/t͡ʃaːlid͡ʒaːit͡ʃʰɔnt̪i/
ଚାଲିଯାଇଛି	/t͡ʃaːlid͡ʒaːit͡ʃʰi/
ଚାଲିଲା	/t͡ʃaːlilaː/
ଚାଲିଲି	/t͡ʃaːlili/
ଚାଲିଲେ	/t͡ʃaːlile/
ଚାଲୁ	/t͡ʃaːlu/
ଚାଲୁଥାଏ	/t͡ʃaːlut̪ʰaːe/
ଚାଲୁଥିବା	/t͡ʃaːlut̪ʰibaː/
ଚାଲୁଥିଲା	/t͡ʃaːlut̪ʰilaː/
ଚାଲୁଥିଲେ	/t͡ʃaːlut̪ʰile/
ଚାଲ୍	/t͡ʃaːl/
ଚାଷ	/t͡ʃaːsɵ/
ଚାଷୀ	/t͡ʃaːsi/
ଚାଷୀଟି	/t͡ʃaːsiʈi/
ଚାହଁ	/t͡ʃaːhɔ̃/
ଚାହାଣୀ	/t͡ʃaːhaːɳi/
ଚାହାନ୍ତି	/t͡ʃaːhaːnt̪i/
ଚାହାଁନ୍ତି	/t͡ʃaːhaː̃nt̪i/
ଚାହିଁ	/t͡ʃaːhĩ/
ଚାହିଁବା	/t͡ʃaːhĩbaː/
ଚାହିଁଲା	/t͡ʃaːhĩlaː/
ଚାହିଁଲେ	/t͡ʃaːhĩle/
ଚାହୁଁ	/t͡ʃaːhũ/
ଚାହୁଁଛି	/t͡ʃaːhũt͡ʃʰi/
ଚାହୁଁଥାଏ	/t͡ʃaːhũt̪ʰaːe/
ଚାହୁଁଥିବ	/t͡ʃaːhũt̪ʰibɔ/
ଚାହୁଁଥିଲା	/t͡ʃaːhũt̪ʰilaː/
ଚାହୁଁଥିଲି	/t͡ʃaːhũt̪ʰili/
ଚାହୁଁଥିଲେ	/t͡ʃaːhũt̪ʰile/
ଚାହୁଁନଥିଲା	/t͡ʃaːhũnɔt̪ʰilaː/
ଚାହେଁ	/t͡ʃaːhẽ/
ଚିକିତ୍ସା	/t͡ʃikit̪saː/
ଚିକିତ୍ସାକଙ୍କ	/t͡ʃikit̪saːkɔŋkɔ/
ଚିକିତ୍ସାବିଜ୍ଞାନ	/t͡ʃikit̪saːbid͡ʒɲaːnɵ/
ଚିକିମିକିଆ	/t͡ʃikimikiaː/
ଚିକ୍	/t͡ʃik/
ଚିଗିଡି	/t͡ʃigiɖi/
ଚିଠି	/t͡ʃiʈʰi/
ଚିଠିଟେ	/t͡ʃiʈʰiʈe/
ଚିଡ଼ାଇଲା	/t͡ʃiɽaːilaː/
ଚିଡ଼ି-ଚିଡ଼ା	/t͡ʃiɽi-t͡ʃiɽaː/
ଚିଡ଼ିଆଖାନା	/t͡ʃiɽiaːkʰaːnaː/
ଚିଡ଼ିଗଲା	/t͡ʃiɽiɡɔlaː/
ଚିଡ଼ିଚିଡ଼ା	/t͡ʃiɽit͡ʃiɽaː/
ଚିଡ଼େଇବାକୁ	/t͡ʃiɽeibaːku/
ଚିଣ୍ଟୁ	/t͡ʃiɳʈu/
ଚିତା	/t͡ʃit̪aː/
ଚିତାବାଘ	/t͡ʃit̪aːbaːɡʱɔ/
ଚିତ୍କାର	/t͡ʃit̪kaːɾɔ/
ଚିତ୍ର	/t͡ʃit̪ɾɵ/
ଚିତ୍ରକାର	/t͡ʃit̪ɾɔkaːɾɔ/
ଚିତ୍ରଥିବା	/t͡ʃit̪ɾɔt̪ʰibaː/
ଚିତ୍ରାଙ୍କନ	/t͡ʃit̪raːŋkɔnɔ/
ଚିନାବାଦାମ	/t͡ʃinaːbaːd̪aːmɔ/
ଚିନାବାଦାମ-ଯାତ୍ରା	/t͡ʃinaːbaːd̪aːmɔ-d͡ʒaːt̪raː/
ଚିନାମାଟିରେ	/t͡ʃinaːmaːʈire/
ଚିନି	/t͡ʃini/
ଚିନୁ	/t͡ʃinu/
ଚିନୁକୁ	/t͡ʃinuku/
ଚିନୁର	/t͡ʃinuɾɔ/
ଚିନ୍ତା	/t͡ʃint̪aː/
ଚିନ୍ତାମଣି	/t͡ʃint̪aːmɵɳi/
ଚିନ୍ତିତ	/t͡ʃint̪it̪ɔ/
ଚିପା	/t͡ʃipaː/
ଚିପି	/t͡ʃipi/
ଚିପ୍‌ସ୍‌	/t͡ʃips/
ଚିବୁକ	/t͡ʃibukɔ/
ଚିବୁକରେ	/t͡ʃibukɔre/
ଚିରି	/t͡ʃiri/
ଚିରିଦେବି	/t͡ʃirid̪ebi/
ଚିଲିକା	/t͡ʃilikaː/
ଚିଲ୍ଲେଇ	/t͡ʃillei/
ଚିହ୍ନ	/t͡ʃihnɵ/
ଚିହ୍ନବର୍ଣ୍ଣ	/t͡ʃihnɔbɔrɳɳɔ/
ଚିହ୍ନି	/t͡ʃihni/
ଚୀତାବାଘ	/t͡ʃit̪aːbaːɡʱɔ/
ଚୀନ	/t͡ʃinɵ/
ଚୀଲ	/t͡ʃilɔ/
ଚୁଡ଼ି	/t͡ʃuɽi/
ଚୁଡ଼ିଦାର	/t͡ʃuɽid̪aːɾɔ/
ଚୁନାରିଆ	/t͡ʃunaːriaː/
ଚୁପ୍‌	/t͡ʃup/
ଚୁପ୍	/t͡ʃup/
ଚୁପ୍‌ଚାପ୍‌	/t͡ʃupt͡ʃaːp/
ଚୁମୁଟି	/t͡ʃumuʈi/
ଚୁମ୍ବକ	/t͡ʃumbɔkɔ/
ଚୁମ୍ବକଟି	/t͡ʃumbɔkɔʈi/
ଚୁମ୍ବକଟିକୁ	/t͡ʃumbɔkɔʈiku/
ଚୁମ୍ବକରେ	/t͡ʃumbɔkɔre/
ଚୁଲି	/t͡ʃuli/
ଚୁଲିଟା	/t͡ʃuliʈaː/
ଚୁଲିରେ	/t͡ʃulire/
ଚୁଲୀ	/t͡ʃuli/
ଚୂଲି	/t͡ʃuli/
ଚୂଲିରୁ	/t͡ʃuliru/
ଚେୟାର	/t͡ʃejaːɾɔ/
ଚେୟାର୍	/t͡ʃejaːr/
ଚେର	/t͡ʃeɾɔ/
ଚେଷ୍ଟା	/t͡ʃesʈaː/
ଚେଷ୍ଟାକର	/t͡ʃesʈaːkɔɾɔ/
ଚେହେରା	/t͡ʃeheraː/
ଚୈତନ୍ୟ	/t͡ʃɵit̪ɵnjɵ/
ଚୈତ୍ର	/t͡ʃɵit̪ɾɵ/
ଚୋବାଇ	/t͡ʃobaːi/
ଚୋବାଇଲା	/t͡ʃobaːilaː/
ଚୋବାଉ	/t͡ʃobaːu/
ଚୋବେଇଲା	/t͡ʃobeilaː/
ଚୋର	/t͡ʃoɾɔ/
ଚୋରଙ୍କୁ	/t͡ʃoɾɔŋku/
ଚୌକପୁର୍ଣ	/t͡ʃɔukɔpurɳɔ/
ଚୌକି	/t͡ʃɔuki/
ଚୌକି-ଟେବୁଲ୍	/t͡ʃɔuki-ʈebul/
ଚୌକିଟିଏ	/t͡ʃɔukiʈie/
ଚୌକିଦାର	/t͡ʃɔukid̪aːɾɔ/
ଚୌକିରେ	/t͡ʃɔukire/
ଚୌଧୁରୀ	/t͡ʃoud̪ʱuri/
ଛଅ	/t͡ʃʰɵɵ/
ଛଟାଣ	/t͡ʃʰɔʈaːɳɔ/
ଛଡା	/t͡ʃʰɵɖaː/
ଛଡ଼ା	/t͡ʃʰɵɽaː/
ଛଣା	/t͡ʃʰɔɳaː/
ଛତା	/t͡ʃʰɔt̪aː/
ଛତିଶଗଡ଼	/t͡ʃʰɵt̪isɵɡɵɖɵ/
ଛତୁ	/t͡ʃʰɵt̪u/
ଛତୁଗୁଡ଼ିକ	/t͡ʃʰɔt̪uguɽikɔ/
ଛତୁଗୁଡ଼ିକୁ	/t͡ʃʰɔt̪uguɽiku/
ଛତୁର	/t͡ʃʰɔt̪uɾɔ/
ଛତୁରୁ	/t͡ʃʰɔt̪uru/
ଛତୁରେ	/t͡ʃʰɔt̪ure/
ଛନ୍ତି	/t͡ʃʰɔnt̪i/
ଛବି	/t͡ʃʰɵbi/
ଛମ୍-ଛମ୍-ଛମ୍	/t͡ʃʰɔm-t͡ʃʰɔm-t͡ʃʰɔm/
ଛଳ-ଛଳ	/t͡ʃʰɔl̪ɔ-t͡ʃʰɔl̪ɔ/
ଛାଇ	/t͡ʃʰaːi/
ଛାଞ୍ଚ	/t͡ʃʰaːɲt͡ʃɵ/
ଛାଡି	/t͡ʃʰaːɖi/
ଛାଡ଼ି	/t͡ʃʰaːɽi/
ଛାଡ଼ି	/t͡ʃʰaːɽi/
ଛାଡ଼ିଗଲେ	/t͡ʃʰaːɽiɡɔle/
ଛାଡ଼ିଦେବା	/t͡ʃʰaːɽid̪ebaː/
ଛାଡିଦେଲେ	/t͡ʃʰaːɖid̪ele/
ଛାଡ଼ିଦେଲେ	/t͡ʃʰaːɽid̪ele/
ଛାଡ଼ିଲା	/t͡ʃʰaːɽilaː/
ଛାଡ଼ିଲାଣି	/t͡ʃʰaːɽilaːɳi/
ଛାଡୁଥିଲା	/t͡ʃʰaːɖut̪ʰilaː/
ଛାଣି	/t͡ʃʰaːɳi/
ଛାଣିବାକୁ	/t͡ʃʰaːɳibaːku/
ଛାଣୁଥିବା	/t͡ʃʰaːɳut̪ʰibaː/
ଛାତ	/t͡ʃʰaːt̪ɔ/
ଛାତରୁ	/t͡ʃʰaːt̪ɔru/
ଛାତରେ	/t͡ʃʰaːt̪ɔre/
ଛାତି	/t͡ʃʰaːt̪i/
ଛାତ୍ର	/t͡ʃʰaːt̪ɾɵ/
ଛାନିଆଁ	/t͡ʃʰaːniaː̃/
ଛାର	/t͡ʃʰaːɾɔ/
ଛିଁ	/t͡ʃʰĩ/
ଛିଃ	/t͡ʃʰih/
ଛିଂକୁ	/t͡ʃʰiŋku/
ଛୁଅଁନା	/t͡ʃʰuɔ̃naː/
ଛୁଆ	/t͡ʃʰuaː/
ଛୁଆକୁ	/t͡ʃʰuaːku/
ଛୁଆଟି	/t͡ʃʰuaːʈi/
ଛୁଆଟିଏ	/t͡ʃʰuaːʈie/
ଛୁଆଟେ	/t͡ʃʰuaːʈe/
ଛୁଇଁ	/t͡ʃʰuĩ/
ଛୁଇଁବ	/t͡ʃʰuĩbɔ/
ଛୁଇଁବାକୁ	/t͡ʃʰuĩbaːku/
ଛୁଞ୍ଚିଟା	/t͡ʃʰuɲt͡ʃiʈaː/
ଛୁଞ୍ଚିଟି	/t͡ʃʰuɲt͡ʃiʈi/
ଛୁଟି	/t͡ʃʰuʈi/
ଛୁଟିରେ	/t͡ʃʰuʈire/
ଛେଚା	/t͡ʃʰet͡ʃaː/
ଛେଳି	/t͡ʃʰel̪i/
ଛେଳିକୁ	/t͡ʃʰel̪iku/
ଛେଳିର	/t͡ʃʰel̪iɾɔ/
ଛୋଟ	/t͡ʃʰoʈɵ/
ଛୋଟପିଲାମାନଙ୍କୁ	/t͡ʃʰoʈɔpilaːmaːnɔŋku/
ଛୋଟରୁ	/t͡ʃʰoʈɔru/
ଛୋଟିଆ	/t͡ʃʰoʈiaː/
ଛୋଟୁ	/t͡ʃʰoʈu/
ଛୋଳି	/t͡ʃʰol̪i/
ଜଗତ	/d͡ʒɵɡɵt̪ɵ/
ଜଗତର	/d͡ʒɵɡɵt̪ɵɾɵ/
ଜଗତସିଂହପୁର	/d͡ʒɵɡɵt̪ɵsiŋhɵpuɾɵ/
ଜଗନ୍ନାଥ	/d͡ʒɵɡɵnnaːt̪ʰɵ/
ଜଗନ୍ନାଥଙ୍କ	/d͡ʒɵɡɵnnaːt̪ʰɵŋkɵ/
ଜଂଗଲ	/d͡ʒɔŋɡɔlɔ/
ଜଂଗଲର	/d͡ʒɔŋɡɔlɔɾɔ/
ଜଙ୍ଗଲ	/d͡ʒɵŋɡɵlɵ/
ଜଙ୍ଗଲଟିର	/d͡ʒɔŋɡɔlɔʈiɾɔ/
ଜଙ୍ଗଲର	/d͡ʒɔŋɡɔlɔɾɔ/
ଜଙ୍ଗଲରେ	/d͡ʒɔŋɡɔlɔre/
ଜଣ	/d͡ʒɵɳɵ/
ଜଣକ	/d͡ʒɔɳɔkɔ/
ଜଣକର	/d͡ʒɔɳɔkɔɾɔ/
ଜଣକରୁ	/d͡ʒɔɳɔkɔru/
ଜଣକୁ	/d͡ʒɔɳɔku/
ଜଣଙ୍କ	/d͡ʒɔɳɔŋkɔ/
ଜଣା	/d͡ʒɵɳaː/
ଜଣାଇଥାନ୍ତି	/d͡ʒɔɳaːit̪ʰaːnt̪i/
ଜଣାଇଦେଇଛନ୍ତି	/d͡ʒɔɳaːid̪eit͡ʃʰɔnt̪i/
ଜଣାଇଲା	/d͡ʒɔɳaːilaː/
ଜଣାଯାଉଛି	/d͡ʒɔɳaːd͡ʒaːut͡ʃʰi/
ଜଣାଯାଏ	/d͡ʒɵɳaːd͡ʒaːe/
ଜଣାଶୁଣା	/d͡ʒɵɳaːsuɳaː/
ଜଣେ	/d͡ʒɵɳe/
ଜଣେଇ	/d͡ʒɔɳei/
ଜଣେଇବ	/d͡ʒɔɳeibɔ/
ଜନ	/d͡ʒɵnɵ/
ଜନଗଣନା	/d͡ʒɵnɵɡɵɳɵnaː/
ଜନଗହଳିର	/d͡ʒɔnɔɡɔhɔl̪iɾɔ/
ଜନଜାତି	/d͡ʒɵnɵd͡ʒaːt̪i/
ଜନତା	/d͡ʒɵnɵt̪aː/
ଜନନୀ	/d͡ʒɵnɵni/
ଜନମ	/d͡ʒɔnɔmɔ/
ଜନସଂଖ୍ୟା	/d͡ʒɵnɵsɵŋkʰjaː/
ଜନସଂଚାର	/d͡ʒɵnɵsɵŋt͡ʃaːɾɵ/
ଜନିତ	/d͡ʒɵnit̪ɵ/
ଜନ୍ମ	/d͡ʒɵnmɵ/
ଜନ୍ମଗ୍ରହଣ	/d͡ʒɵnmɵgɾɵhɵɳɵ/
ଜନ୍ମତିଥି	/d͡ʒɵnmɵt̪it̪ʰi/
ଜନ୍ମଦିନ	/d͡ʒɔnmɔd̪inɔ/
ଜନ୍ମହୋଇ	/d͡ʒɔnmɔhoi/
ଜନ୍ମିତ	/d͡ʒɵnmit̪ɵ/
ଜମା	/d͡ʒɔmaː/
ଜମି	/d͡ʒɵmi/
ଜମିଯାଇଛି	/d͡ʒɔmid͡ʒaːit͡ʃʰi/
ଜୟ	/d͡ʒɵjɵ/
ଜୟଦେବ	/d͡ʒɵjɵd̪ebɵ/
ଜୟପୁର	/d͡ʒɵjɵpuɾɵ/
ଜୟସାମଲେର୍	/d͡ʒɔjɔsaːmɔler/
ଜୟସାଲମେର	/d͡ʒɔjɔsaːlɔmeɾɔ/
ଜୟୀରାମ	/d͡ʒɵjiraːmɵ/
ଜର	/d͡ʒɵɾɵ/
ଜରୁରି	/d͡ʒɔruri/
ଜର୍ଜ	/d͡ʒɵrd͡ʒɵ/
ଜର୍ମାନୀ	/d͡ʒɵrmaːni/
ଜର୍ମାନୀର	/d͡ʒɵrmaːniɾɵ/
ଜଲାଲୁଦ୍ଦିନ	/d͡ʒɔlaːlud̪d̪inɔ/
ଜଲେବି	/d͡ʒɔlebi/
ଜଲ୍ଦି	/d͡ʒɔld̪i/
ଜଳ	/d͡ʒɵl̪ɵ/
ଜଳନ୍ତି	/d͡ʒɔl̪ɔnt̪i/
ଜଳପ୍ରପାତ	/d͡ʒɵl̪ɵpɾɵpaːt̪ɵ/
ଜଳବାୟୁରେ	/d͡ʒɔl̪ɔbaːjure/
ଜଳରେ	/d͡ʒɵl̪ɵre/
ଜଳାଇ	/d͡ʒɔl̪aːi/
ଜଳି	/d͡ʒɔl̪i/
ଜଳିବାରେ	/d͡ʒɔl̪ibaːre/
ଜଳୁ	/d͡ʒɔl̪u/
ଜଳୁଥିବା	/d͡ʒɔl̪ut̪ʰibaː/
ଜଳୁନି	/d͡ʒɔl̪uni/
ଜଳେ	/d͡ʒɔl̪e/
ଜସମିତ	/d͡ʒɔsɔmit̪ɔ/
ଜହ୍ନ	/d͡ʒɔhnɔ/
ଜହ୍ନଟି	/d͡ʒɔhnɔʈi/
ଜହ୍ନର	/d͡ʒɔhnɔɾɔ/
ଜାକି	/d͡ʒaːki/
ଜାଗର	/d͡ʒaːɡɔɾɔ/
ଜାଗା	/d͡ʒaːgaː/
ଜାଗାକୁ	/d͡ʒaːgaːku/
ଜାଗାଟି	/d͡ʒaːgaːʈi/
ଜାଗାର	/d͡ʒaːgaːɾɔ/
ଜାଗାରେ	/d͡ʒaːgaːre/
ଜାଣ	/d͡ʒaːɳɔ/
ଜାଣକି	/d͡ʒaːɳɔki/
ଜାଣି	/d͡ʒaːɳi/
ଜାଣିଗଲ	/d͡ʒaːɳiɡɔlɔ/
ଜାଣିଛ	/d͡ʒaːɳit͡ʃʰɔ/
ଜାଣିଛନ୍ତି	/d͡ʒaːɳit͡ʃʰɔnt̪i/
ଜାଣିଛି	/d͡ʒaːɳit͡ʃʰi/
ଜାଣିଛୁ	/d͡ʒaːɳit͡ʃʰu/
ଜାଣିଥିଲା	/d͡ʒaːɳit̪ʰilaː/
ଜାଣିଥିଲି	/d͡ʒaːɳit̪ʰili/
ଜାଣିଥିଲେ	/d͡ʒaːɳit̪ʰile/
ଜାଣିନଥିଲା	/d͡ʒaːɳinɔt̪ʰilaː/
ଜାଣିନି	/d͡ʒaːɳini/
ଜାଣିନୁ	/d͡ʒaːɳinu/
ଜାଣିପାରିବ	/d͡ʒaːɳipaːribɔ/
ଜାଣିପାରିଲା	/d͡ʒaːɳipaːrilaː/
ଜାଣିପାରୁଛି	/d͡ʒaːɳipaːrut͡ʃʰi/
ଜାଣିବା	/d͡ʒaːɳibaː/
ଜାଣିବାକୁ	/d͡ʒaːɳibaːku/
ଜାଣିବେ	/d͡ʒaːɳibe/
ଜାଣିଲା	/d͡ʒaːɳilaː/
ଜାଣୁ	/d͡ʒaːɳu/
ଜାଣେ	/d͡ʒaːɳe/
ଜାତ	/d͡ʒaːt̪ɵ/
ଜାତି	/d͡ʒaːt̪i/
ଜାତିର	/d͡ʒaːt̪iɾɵ/
ଜାତୀୟ	/d͡ʒaːt̪ijɵ/
ଜାନକୀ	/d͡ʒaːnɵki/
ଜାନୁ	/d͡ʒaːnu/
ଜାନୁଆରୀ	/d͡ʒaːnuaːri/
ଜାବୁଡ଼ି	/d͡ʒaːbuɽi/
ଜାମା	/d͡ʒaːmaː/
ଜାମାକୁ	/d͡ʒaːmaːku/
ଜାରରେ	/d͡ʒaːɾɔre/
ଜାର୍	/d͡ʒaːr/
ଜାଲ	/d͡ʒaːlɔ/
ଜାଲନେଇ	/d͡ʒaːlɔnei/
ଜାଲରେ	/d͡ʒaːlɔre/
ଜାଳିଥିଲେ	/d͡ʒaːl̪it̪ʰile/
ଜାଳିବାକୁ	/d͡ʒaːl̪ibaːku/
ଜାହାନାରା	/d͡ʒaːhaːnaːraː/
ଜି	/d͡ʒi/
ଜିନିଷ	/d͡ʒinisɔ/
ଜିନିଷକୁ	/d͡ʒinisɔku/
ଜିନିଷଗୁଡ଼ା	/d͡ʒinisɔguɽaː/
ଜିନିଷଟି	/d͡ʒinisɔʈi/
ଜିନିଷଟିଏ	/d͡ʒinisɔʈie/
ଜିଭ	/d͡ʒibʰɔ/
ଜିରା	/d͡ʒiraː/
ଜିରାଫ	/d͡ʒiraːpʰɔ/
ଜିଲା	/d͡ʒilaː/
ଜିଲାପି	/d͡ʒilaːpi/
ଜିଲ୍ଲା	/d͡ʒillaː/
ଜିଲ୍ଲାମାନଙ୍କର	/d͡ʒillaːmaːnɵŋkɵɾɵ/
ଜିଲ୍ଲାର	/d͡ʒillaːɾɵ/
ଜିଲ୍ଲାରେ	/d͡ʒillaːre/
ଜୀବ	/d͡ʒibɵ/
ଜୀବକୁ	/d͡ʒibɔku/
ଜୀବଜଗତ	/d͡ʒibɵd͡ʒɵɡɵt̪ɵ/
ଜୀବଟି	/d͡ʒibɵʈi/
ଜୀବନ	/d͡ʒibɵnɵ/
ଜୀବନର	/d͡ʒibɵnɵɾɵ/
ଜୀବନରେ	/d͡ʒibɵnɵre/
ଜୀବନୀ	/d͡ʒibɵni/
ଜୀବାଣୁ	/d͡ʒibaːɳu/
ଜୀବାଶ୍ମ	/d͡ʒibaːsmɵ/
ଜୀବିତ	/d͡ʒibit̪ɵ/
ଜୀରା	/d͡ʒiraː/
ଜୁଇ	/d͡ʒui/
ଜୁନ	/d͡ʒunɵ/
ଜୁରାସିକ	/d͡ʒuraːsikɵ/
ଜୁଲାଇ	/d͡ʒulaːi/
ଜୁଳୁଜୁଳିଆ	/d͡ʒul̪ud͡ʒul̪iaː/
ଜେ	/d͡ʒe/
ଜେଜେ	/d͡ʒed͡ʒe/
ଜେଜେଙ୍କର	/d͡ʒed͡ʒeŋkɔɾɔ/
ଜେଜେବାପା	/d͡ʒed͡ʒebaːpaː/
ଜେଜେବାପାଙ୍କ	/d͡ʒed͡ʒebaːpaːŋkɔ/
ଜେଜେବାପାଙ୍କର	/d͡ʒed͡ʒebaːpaːŋkɔɾɔ/
ଜେଜେମା	/d͡ʒed͡ʒemaː/
ଜେନା	/d͡ʒenaː/
ଜେରା	/d͡ʒeraː/
ଜୈନ	/d͡ʒɵinɵ/
ଜୈବସନ୍ଦିପ୍ତ	/d͡ʒɔibɔsɔnd̪ipt̪ɔ/
ଜୋତା	/d͡ʒot̪aː/
ଜୋରରେ	/d͡ʒoɾɔre/
ଜୋର୍	/d͡ʒor/
ଜୋର୍‌ରେ	/d͡ʒorre/
ଜ୍ଞାନ	/d͡ʒɲaːnɵ/
ଜ୍ଞାନକୋଷ	/d͡ʒɲaːnɵkosɵ/
ଜ୍ଞାନପୀଠ	/d͡ʒɲaːnɵpiʈʰɵ/
ଜ୍ୟାକେଟ୍	/d͡ʒjaːkeʈ/
ଜ୍ୟେଷ୍ଠ	/d͡ʒjesʈʰɵ/
ଜ୍ୟୋତିର୍ଲିଙ୍ଗ	/d͡ʒjot̪irliŋɡɵ/
ଜ୍ଵର	/d͡ʒuɵɾɵ/
ଜ୍ୱର	/d͡ʒuɔɾɔ/
ଝଗଡା	/d͡ʒʱɔɡɔɖaː/
ଝଟ୍	/d͡ʒʱɔʈ/
ଝଡି	/d͡ʒʱɔɖi/
ଝଡିବା	/d͡ʒʱɔɖibaː/
ଝପଟିଗଲା	/d͡ʒʱɔpɔʈiɡɔlaː/
ଝରକା	/d͡ʒʱɔɾɔkaː/
ଝରକାର	/d͡ʒʱɔɾɔkaːɾɔ/
ଝରକାରେ	/d͡ʒʱɔɾɔkaːre/
ଝରଣା	/d͡ʒʱɵɾɵɳaː/
ଝରଣାଟିଏ	/d͡ʒʱɔɾɔɳaːʈie/
ଝରଣାର	/d͡ʒʱɔɾɔɳaːɾɔ/
ଝରଣାରୁ	/d͡ʒʱɔɾɔɳaːru/
ଝର୍କା	/d͡ʒʱɔrkaː/
ଝାଉଁଳି	/d͡ʒʱaːũl̪i/
ଝାଡ଼ଖଣ୍ଡ	/d͡ʒʱaːɖɵkʰɵɳɖɵ/
ଝାଡ଼ିଲା	/d͡ʒʱaːɽilaː/
ଝାରସୁଗୁଡ଼ା	/d͡ʒʱaːɾɵsuguɽaː/
ଝାଳ	/d͡ʒʱaːl̪ɔ/
ଝାଳରେ	/d͡ʒʱaːl̪ɔre/
ଝିଅ	/d͡ʒʱiɵ/
ଝିଅକୁ	/d͡ʒʱiɔku/
ଝିଅଟି	/d͡ʒʱiɔʈi/
ଝିଅଟିଏ	/d͡ʒʱiɔʈie/
ଝିଅରେ	/d͡ʒʱiɔre/
ଝିଙ୍କ	/d͡ʒʱiŋkɔ/
ଝୁଙ୍କିପଡ଼ି	/d͡ʒʱuŋkipɔɽi/
ଝୁଙ୍କେଇ	/d͡ʒʱuŋkei/
ଝୁଡ଼ି	/d͡ʒʱuɽi/
ଝୁଣ୍ଟିକି	/d͡ʒʱuɳʈiki/
ଝୁଲା	/d͡ʒʱulaː/
ଝୁଲାଇ	/d͡ʒʱulaːi/
ଝୁଲି	/d͡ʒʱuli/
ଝୁଲୁଥାଅ	/d͡ʒʱulut̪ʰaːɔ/
ଝୁଲୁଥିଲା	/d͡ʒʱulut̪ʰilaː/
ଝୁଲେଇ	/d͡ʒʱulei/
ଝୋଟି	/d͡ʒʱoʈi/
ଟଗର	/ʈɔɡɔɾɔ/
ଟଙ୍କା	/ʈɵŋkaː/
ଟଙ୍କାରେ	/ʈɔŋkaːre/
ଟପିଗଲା	/ʈɔpiɡɔlaː/
ଟପିଲେ	/ʈɔpile/
ଟମାଟର୍	/ʈɔmaːʈɔr/
ଟମାଟୋ	/ʈɔmaːʈo/
ଟର୍ଚ୍	/ʈɔrt͡ʃ/
ଟା	/ʈaː/
ଟାଇପ	/ʈaːipɵ/
ଟାକୁ	/ʈaːku/
ଟାଙ୍କି	/ʈaːŋki/
ଟାଙ୍ଗୁ	/ʈaːŋgu/
ଟାଣି	/ʈaːɳi/
ଟାଣିଦେଲେ	/ʈaːɳid̪ele/
ଟାଣିନେଲେ	/ʈaːɳinele/
ଟାଣିଲା	/ʈaːɳilaː/
ଟାପରା	/ʈaːpɔraː/
ଟି	/ʈi/
ଟିଂ	/ʈiŋ/
ଟିଏ	/ʈie/
ଟିକା	/ʈikaː/
ଟିକି	/ʈiki/
ଟିକିଏ	/ʈikie/
ଟିକୁ	/ʈiku/
ଟିକେ	/ʈike/
ଟିଙ୍ଗୁ	/ʈiŋgu/
ଟିଚର	/ʈit͡ʃɔɾɔ/
ଟିପ୍ପଣୀ	/ʈippɔɳi/
ଟିଫିନ	/ʈipʰinɔ/
ଟିଭି	/ʈibʱi/
ଟିମି	/ʈimi/
ଟିମ୍-ଟିମ୍	/ʈim-ʈim/
ଟୀକା	/ʈikaː/
ଟୁକୁଡ଼ା	/ʈukuɽaː/
ଟୁଥପେଷ୍ଟ	/ʈut̪ʰɔpesʈɔ/
ଟୁଥପେଷ୍ଟ୍	/ʈut̪ʰɔpesʈ/
ଟୁଲୁ	/ʈulu/
ଟେକି	/ʈeki/
ଟେନିସ	/ʈenisɔ/
ଟେଁପଲେଟ	/ʈẽpɵleʈɵ/
ଟେବୁଲ	/ʈebulɔ/
ଟେବୁଲରେ	/ʈebulɔre/
ଟେବୁଲ୍	/ʈebul/
ଟେମ୍ପଲେଟ	/ʈempɵleʈɵ/
ଟେଲିଭିଜନ	/ʈelibʱid͡ʒɵnɵ/
ଟେସୁ	/ʈesu/
ଟୋକା	/ʈokaː/
ଟୋକେଇକୁ	/ʈokeiku/
ଟୋକେଇରେ	/ʈokeire/
ଟୋପା	/ʈopaː/
ଟୋପି	/ʈopi/
ଟୋପିକୁ	/ʈopiku/
ଟୋପିଟିଏ	/ʈopiʈie/
ଟ୍ୟୁବ୍	/ʈjub/
ଟ୍ରକ	/ʈɾɔkɔ/
ଟ୍ରାଇଆସିକ	/ʈraːiaːsikɵ/
ଟ୍ରେନରେ	/ʈrenɔre/
ଟ୍ରେନ୍	/ʈren/
ଠକିବ	/ʈʰɔkibɔ/
ଠକ୍‌	/ʈʰɔk/
ଠକ୍	/ʈʰɔk/
ଠା	/ʈʰaː/
ଠାକୁର	/ʈʰaːkuɾɵ/
ଠାକୁର-ଠାକୁରାଣୀଙ୍କ	/ʈʰaːkuɾɔ-ʈʰaːkuraːɳiŋkɔ/
ଠାକୁରାଣୀ	/ʈʰaːkuraːɳi/
ଠାଣିରେ	/ʈʰaːɳire/
ଠାରୁ	/ʈʰaːru/
ଠାରେ	/ʈʰaːre/
ଠିଆ	/ʈʰiaː/
ଠିକ	/ʈʰikɵ/
ଠିକଣା	/ʈʰikɔɳaː/
ଠିକ୍‌	/ʈʰik/
ଠିକ୍	/ʈʰik/
ଠିପି	/ʈʰipi/
ଠିପିରେ	/ʈʰipire/
ଠୁ	/ʈʰu/
ଠେକୁଆ	/ʈʰekuaː/
ଠେକୁଆଙ୍କୁ	/ʈʰekuaːŋku/
ଠେକୁଆଠୁ	/ʈʰekuaːʈʰu/
ଠେଙ୍ଗା	/ʈʰeŋgaː/
ଠେଲା	/ʈʰelaː/
ଠେଲାଗାଡ଼ି	/ʈʰelaːgaːɽi/
ଠେଲାରୁ	/ʈʰelaːru/
ଡଙ୍ଗା	/ɖɔŋgaː/
ଡଙ୍ଗାର	/ɖɔŋgaːɾɔ/
ଡବା	/ɖɔbaː/
ଡବାଟି	/ɖɔbaːʈi/
ଡର	/ɖɔɾɔ/
ଡରନ୍ତି	/ɖɔɾɔnt̪i/
ଡରନ୍ତିନି	/ɖɔɾɔnt̪ini/
ଡରାଉ	/ɖɔraːu/
ଡରି	/ɖɔri/
ଡରିକି	/ɖɔriki/
ଡରିଗଲା	/ɖɔriɡɔlaː/
ଡରିଗଲେ	/ɖɔriɡɔle/
ଡରିଡରି	/ɖɔriɖɔri/
ଡରିଯାନ୍ତି	/ɖɔrid͡ʒaːnt̪i/
ଡରୁ	/ɖɔru/
ଡରୁଆ	/ɖɔruaː/
ଡରୁଥିଲା	/ɖɔrut̪ʰilaː/
ଡରେ	/ɖɔre/
ଡରେଇ	/ɖɔrei/
ଡାଇନୋସର	/ɖaːinosɵɾɵ/
ଡାଇନୋସରଟି	/ɖaːinosɵɾɵʈi/
ଡାକ	/ɖaːkɵ/
ଡାକବାକ୍ସରେ	/ɖaːkɔbaːksɔre/
ଡାକି	/ɖaːki/
ଡାକିବା	/ɖaːkibaː/
ଡାକିବାକୁ	/ɖaːkibaːku/
ଡାକିଲେ	/ɖaːkile/
ଡାକୁଛି	/ɖaːkut͡ʃʰi/
ଡାକୁଥିବାର	/ɖaːkut̪ʰibaːɾɔ/
ଡାକୁଥିଲେ	/ɖaːkut̪ʰile/
ଡାକ୍ଟର	/ɖaːkʈɔɾɔ/
ଡାକ୍ଟରଙ୍କ	/ɖaːkʈɔɾɔŋkɔ/
ଡାକ୍ଟରଙ୍କର	/ɖaːkʈɔɾɔŋkɔɾɔ/
ଡାକ୍ତର	/ɖaːkt̪ɔɾɔ/
ଡାଲଚିନି	/ɖaːlɔt͡ʃini/
ଡାଲି	/ɖaːli/
ଡାଳମାନେ	/ɖaːl̪ɔmaːne/
ଡାଳରୁ	/ɖaːl̪ɔru/
ଡାଳରେ	/ɖaːl̪ɔre/
ଡାହାଣ	/ɖaːhaːɳɵ/
ଡାହାଣକୁ	/ɖaːhaːɳɔku/
ଡି	/ɖi/
ଡିଆଁ	/ɖiaː̃/
ଡିଆଁଇ	/ɖiaː̃i/
ଡିଆଁମାରି	/ɖiaː̃maːri/
ଡିଏଁ	/ɖiẽ/
ଡିଗ୍ରୀ	/ɖigri/
ଡିଜାଇନ	/ɖid͡ʒaːinɔ/
ଡିଭାଇଡର୍‌ରେ	/ɖibʱaːiɖɔrre/
ଡିସେମ୍ବର	/ɖisembɵɾɵ/
ଡୁଡୁମ୍	/ɖuɖum/
ଡେ	/ɖe/
ଡେଇଁ	/ɖeĩ/
ଡ଼େଇଁ	/ɽeĩ/
ଡେଇଁକି	/ɖeĩki/
ଡେଇଁବି	/ɖeĩbi/
ଡେଇଁବୁ	/ɖeĩbu/
ଡେଉଁ	/ɖeũ/
ଡେଉଁଥିଲେ	/ɖeũt̪ʰile/
ଡେଙ୍ଗା	/ɖeŋgaː/
ଡେଣା	/ɖeɳaː/
ଡେଣାର	/ɖeɳaːɾɔ/
ଡେରି	/ɖeri/
ଡ୍ରମ	/ɖɾɔmɔ/
ଢଳ-ଢଳ	/ɖʱɔl̪ɔ-ɖʱɔl̪ɔ/
ଢାକି	/ɖʱaːki/
ଢାଳ	/ɖʱaːl̪ɔ/
ଢାଳି	/ɖʱaːl̪i/
ଢାଳିଲେ	/ɖʱaːl̪ile/
ଢିଙ୍କି	/ɖʱiŋki/
ଢିଲା	/ɖʱilaː/
ଢେଙ୍କାନାଳ	/ɖʱeŋkaːnaːl̪ɵ/
ଢୋକିପାରିଲା	/ɖʱokipaːrilaː/
ଢୋକେ	/ɖʱoke/
ଢୋଲଟେ	/ɖʱolɔʈe/
ତକିଆ	/t̪ɔkiaː/
ତତେ	/t̪ɔt̪e/
ତତ୍କାଳୀନ	/t̪ɵt̪kaːl̪inɵ/
ତତ୍ତ୍ଵ	/t̪ɵt̪t̪uɵ/
ତଥା	/t̪ɵt̪ʰaː/
ତଥାପି	/t̪ɵt̪ʰaːpi/
ତଥ୍ୟ	/t̪ɵt̪ʰjɵ/
ତନ୍ତୁ	/t̪ɵnt̪u/
ତନ୍ତୁଯୁକ୍ତ	/t̪ɔnt̪ud͡ʒukt̪ɔ/
ତନ୍ତ୍ର	/t̪ɵnt̪ɾɵ/
ତନ୍ଦ୍ରା	/t̪ɵnd̪raː/
ତନ୍ମଧ୍ୟରୁ	/t̪ɔnmɔd̪ʱjɔru/
ତପସ୍ୟା	/t̪ɵpɵsjaː/
ତମ	/t̪ɵmɵ/
ତମକୁ	/t̪ɔmɔku/
ତମର	/t̪ɔmɔɾɔ/
ତମେ	/t̪ɵme/
ତରକାରୀ	/t̪ɔɾɔkaːri/
ତରଙ୍ଗ	/t̪ɵɾɵŋɡɵ/
ତରତର	/t̪ɔɾɔt̪ɔɾɔ/
ତରତରରେ	/t̪ɔɾɔt̪ɔɾɔre/
ତରଫରୁ	/t̪ɵɾɵpʰɵru/
ତରଭୁଜ	/t̪ɔɾɔbʱud͡ʒɔ/
ତରଳ	/t̪ɵɾɵl̪ɵ/
ତରାଟି	/t̪ɔraːʈi/
ତରୁଣ	/t̪ɔruɳɔ/
ତରୁଲତା	/t̪ɔrulɔt̪aː/
ତଳ	/t̪ɵl̪ɵ/
ତଳକୁ	/t̪ɵl̪ɵku/
ତଳଥାକ	/t̪ɔl̪ɔt̪ʰaːkɔ/
ତଳପଟେ	/t̪ɔl̪ɔpɔʈe/
ତଳର	/t̪ɔl̪ɔɾɔ/
ତଳୁ	/t̪ɔl̪u/
ତଳୁ-ଉପର	/t̪ɔl̪u-upɔɾɔ/
ତଳେ	/t̪ɵl̪e/
ତହସିଲ	/t̪ɵhɵsilɵ/
ତହାମଧ୍ୟ	/t̪ɔhaːmɔd̪ʱjɔ/
ତା	/t̪aː/
ତା'ର	/t̪aːɾɔ/
ତାଂକ	/t̪aːŋkɔ/
ତାକଥା	/t̪aːkɔt̪ʰaː/
ତାକୁ	/t̪aːku/
ତାଂକୁ	/t̪aːŋku/
ତାକୁତ	/t̪aːkut̪ɔ/
ତାଙ୍କ	/t̪aːŋkɵ/
ତାଙ୍କର	/t̪aːŋkɵɾɵ/
ତାଙ୍କୁ	/t̪aːŋku/
ତାଜା	/t̪aːd͡ʒaː/
ତାଟିଆରେ	/t̪aːʈiaːre/
ତାଠୁଁ	/t̪aːʈʰũ/
ତାତି	/t̪aːt̪i/
ତାନସେନ	/t̪aːnɔsenɔ/
ତାପମାତ୍ରା	/t̪aːpɵmaːt̪raː/
ତାପରେ	/t̪aːpɔre/
ତାମିଲ	/t̪aːmilɵ/
ତାମିଲନାଡୁ	/t̪aːmilɵnaːɖu/
ତାମିଲ୍	/t̪aːmil/
ତାର	/t̪aːɾɵ/
ତାରା	/t̪aːraː/
ତାରାଭଳି	/t̪aːraːbʰɔl̪i/
ତାରାମାନେ	/t̪aːraːmaːne/
ତାରିଖ	/t̪aːrikʰɵ/
ତାରିଖରେ	/t̪aːrikʰɵre/
ତାରେ	/t̪aːre/
ତାଲିକା	/t̪aːlikaː/
ତାଳ	/t̪aːl̪ɵ/
ତାଳଚେର	/t̪aːl̪ɵt͡ʃeɾɵ/
ତାଳିର	/t̪aːl̪iɾɔ/
ତାୱା	/t̪aːuaː/
ତାହା	/t̪aːhaː/
ତାହାକୁ	/t̪aːhaːku/
ତାହାର	/t̪aːhaːɾɵ/
ତାହାହେଲେ	/t̪aːhaːhele/
ତାହେଲେ	/t̪aːhele/
ତିଆରି	/t̪iaːri/
ତିଆରିକଲେ	/t̪iaːrikɵle/
ତିଥି	/t̪it̪ʰi/
ତିଥିରେ	/t̪it̪ʰire/
ତିନି	/t̪ini/
ତିନିକୋଣିଆ	/t̪inikoɳiaː/
ତିନିଥର	/t̪init̪ʰɔɾɔ/
ତିନୋଟି	/t̪inoʈi/
ତୀବ୍ର	/t̪ibɾɵ/
ତୀବ୍ରତର	/t̪ibɾɔt̪ɔɾɔ/
ତୀର୍ଥ	/t̪irt̪ʰɵ/
ତୁ	/t̪u/
ତୁତିର	/t̪ut̪iɾɔ/
ତୁମ	/t̪umɔ/
ତୁମକୁ	/t̪umɔku/
ତୁମଠାରୁ	/t̪umɔʈʰaːru/
ତୁମଠୁ	/t̪umɔʈʰu/
ତୁମମାନଙ୍କର	/t̪umɔmaːnɔŋkɔɾɔ/
ତୁମର	/t̪umɔɾɔ/
ତୁମେ	/t̪ume/
ତୁରନ୍ତ	/t̪uɾɔnt̪ɔ/
ତୁଳନାରେ	/t̪ul̪ɔnaːre/
ତୁଳସୀ	/t̪ul̪ɵsi/
ତୁଳା	/t̪ul̪aː/
ତୁଳାର	/t̪ul̪aːɾɔ/
ତୁଳୀ	/t̪ul̪i/
ତୃତୀୟ	/t̪rut̪ijɵ/
ତୃତୀୟା	/t̪rut̪ijaː/
ତେଜ	/t̪ed͡ʒɵ/
ତେଢ଼ାମେଢ଼ା	/t̪eɽʱaːmeɽʱaː/
ତେଣୁ	/t̪eɳu/
ତେବେ	/t̪ebe/
ତେବେବି	/t̪ebebi/
ତେଲ	/t̪elɵ/
ତେଲୁଗୁ	/t̪elugu/
ତେଲେଙ୍ଗାନା	/t̪eleŋgaːnaː/
ତୋ	/t̪o/
ତୋଟା	/t̪oʈaː/
ତୋତା	/t̪ot̪aː/
ତୋତେ	/t̪ot̪e/
ତୋର	/t̪oɾɔ/
ତୋରଣ	/t̪oɾɔɳɔ/
ତୋଲିଲା	/t̪olilaː/
ତୋଳା	/t̪ol̪aː/
ତୋଳିଲା	/t̪ol̪ilaː/
ତୋଳୁଥିଲା	/t̪ol̪ut̪ʰilaː/
ତ୍ୟାଗ	/t̪jaːɡɵ/
ତ୍ରିପାଠୀ	/t̪ripaːʈʰi/
ଥକି	/t̪ʰɔki/
ଥକିଗଲା	/t̪ʰɔkiɡɔlaː/
ଥକିଗଲେ	/t̪ʰɔkiɡɔle/
ଥକିଯାଉଥାଏ	/t̪ʰɔkid͡ʒaːut̪ʰaːe/
ଥଟ୍ଟା	/t̪ʰɔʈʈaː/
ଥଣ୍ଟରେ	/t̪ʰɔɳʈɔre/
ଥଣ୍ଡା	/t̪ʰɵɳɖaː/
ଥଣ୍ଡାରେ	/t̪ʰɔɳɖaːre/
ଥପ	/t̪ʰɔpɔ/
ଥପା	/t̪ʰɔpaː/
ଥପ୍‌	/t̪ʰɔp/
ଥମ୍	/t̪ʰɔm/
ଥର	/t̪ʰɵɾɵ/
ଥରକେ	/t̪ʰɔɾɔke/
ଥରହର	/t̪ʰɔɾɔhɔɾɔ/
ଥରି	/t̪ʰɔri/
ଥରିଥରି	/t̪ʰɔrit̪ʰɔri/
ଥରୁଥିଲେ	/t̪ʰɔrut̪ʰile/
ଥରେ	/t̪ʰɵre/
ଥା	/t̪ʰaː/
ଥାଆନ୍ତା	/t̪ʰaːaːnt̪aː/
ଥାଆନ୍ତି	/t̪ʰaːaːnt̪i/
ଥାଇ	/t̪ʰaːi/
ଥାଉ	/t̪ʰaːu/
ଥାଏ	/t̪ʰaːe/
ଥାକର	/t̪ʰaːkɔɾɔ/
ଥାକରେ	/t̪ʰaːkɔre/
ଥାନ୍ତା	/t̪ʰaːnt̪aː/
ଥାନ୍ତି	/t̪ʰaːnt̪i/
ଥାପୁଡ଼େଇବାକୁ	/t̪ʰaːpuɽeibaːku/
ଥାଳି	/t̪ʰaːl̪i/
ଥାଳିରେ	/t̪ʰaːl̪ire/
ଥିବା	/t̪ʰibaː/
ଥିବାବେଳେ	/t̪ʰibaːbel̪e/
ଥିବାର	/t̪ʰibaːɾɔ/
ଥିବାରୁ	/t̪ʰibaːru/
ଥିଲ	/t̪ʰilɔ/
ଥିଲା	/t̪ʰilaː/
ଥିଲାଇମ୍ମା	/t̪ʰilaːimmaː/
ଥିଲି	/t̪ʰili/
ଥିଲୁ	/t̪ʰilu/
ଥିଲେ	/t̪ʰile/
ଥୀରି	/t̪ʰiri/
ଥୁଆ	/t̪ʰuaː/
ଥୋଇଦେଇ	/t̪ʰoid̪ei/
ଦଉଛି	/d̪ɔut͡ʃʰi/
ଦଉଡି	/d̪ɔuɖi/
ଦଉଡ଼ି	/d̪ɔuɽi/
ଦଉଡ଼ିଲା	/d̪ɔuɽilaː/
ଦକ୍ଷ	/d̪ɔkʰjɔ/
ଦକ୍ଷିଣ	/d̪ɵkʰiɳɵ/
ଦଣ୍ଡ	/d̪ɵɳɖɵ/
ଦନ୍ତ	/d̪ɔnt̪ɔ/
ଦମଦାର୍	/d̪ɔmɔd̪aːr/
ଦମ୍	/d̪ɔm/
ଦମ୍-ଦମା-ଦମ୍	/d̪ɔm-d̪ɔmaː-d̪ɔm/
ଦମ୍ଭ	/d̪ɔmbʰɔ/
ଦମ୍ଭରେ	/d̪ɔmbʰɔre/
ଦୟାକରି	/d̪ɵjaːkɵri/
ଦୟାରେ	/d̪ɔjaːre/
ଦୟାଳୁ	/d̪ɔjaːl̪u/
ଦରକାର	/d̪ɵɾɵkaːɾɵ/
ଦରକାରୀ	/d̪ɔɾɔkaːri/
ଦରଜ	/d̪ɔɾɔd͡ʒɔ/
ଦରଜି	/d̪ɔɾɔd͡ʒi/
ଦରଜିର	/d̪ɔɾɔd͡ʒiɾɔ/
ଦରଜୀ	/d̪ɔɾɔd͡ʒi/
ଦରବାରରେ	/d̪ɔɾɔbaːɾɔre/
ଦରି	/d̪ɔri/
ଦରୁଆନଟି	/d̪ɔruaːnɔʈi/
ଦର୍ପଣରେ	/d̪ɔrpɔɳɔre/
ଦର୍ଶନ	/d̪ɵrsɵnɵ/
ଦର୍ଶନୀୟ	/d̪ɵrsɵnijɵ/
ଦଳ	/d̪ɵl̪ɵ/
ଦଳଗତ	/d̪ɔl̪ɔɡɔt̪ɔ/
ଦଳର	/d̪ɵl̪ɵɾɵ/
ଦଳେ	/d̪ɔl̪e/
ଦଂଶ	/d̪ɔŋsɔ/
ଦଶ	/d̪ɵsɵ/
ଦଶକ	/d̪ɵsɵkɵ/
ଦଶଜଣ	/d̪ɔsɔd͡ʒɔɳɔ/
ଦଶଥର	/d̪ɔsɔt̪ʰɔɾɔ/
ଦଶମୀ	/d̪ɵsɵmi/
ଦଶହରା	/d̪ɵsɵhɵraː/
ଦଶହେରି	/d̪ɔsɔheri/
ଦସ୍ତାନ	/d̪ɔst̪aːnɔ/
ଦହି	/d̪ɵhi/
ଦାଣ୍ତି	/d̪aːɳt̪i/
ଦାଣ୍ତିକୁ	/d̪aːɳt̪iku/
ଦାଣ୍ତିଯାତ୍ରାର	/d̪aːɳt̪id͡ʒaːt̪raːɾɔ/
ଦାଣ୍ତିରେ	/d̪aːɳt̪ire/
ଦାଦା	/d̪aːd̪aː/
ଦାଦାକୁ	/d̪aːd̪aːku/
ଦାଦାଙ୍କ	/d̪aːd̪aːŋkɔ/
ଦାନ	/d̪aːnɵ/
ଦାନ୍ତ	/d̪aːnt̪ɵ/
ଦାନ୍ତକାଠିରେ	/d̪aːnt̪ɔkaːʈʰire/
ଦାନ୍ତକୁ	/d̪aːnt̪ɔku/
ଦାନ୍ତଟା	/d̪aːnt̪ɔʈaː/
ଦାନ୍ତବିଂଧା	/d̪aːnt̪ɔbiŋd̪ʱaː/
ଦାନ୍ତବିନ୍ଧା	/d̪aːnt̪ɔbind̪ʱaː/
ଦାନ୍ତର	/d̪aːnt̪ɔɾɔ/
ଦାନ୍ତରେ	/d̪aːnt̪ɔre/
ଦାମିକିଆ	/d̪aːmikiaː/
ଦାମ୍	/d̪aːm/
ଦାୟକ	/d̪aːjɔkɔ/
ଦାୟିତ୍ଵ	/d̪aːjit̪uɵ/
ଦାଲଚିନି	/d̪aːlɔt͡ʃini/
ଦାଶ	/d̪aːsɵ/
ଦାସ	/d̪aːsɵ/
ଦାସଙ୍କ	/d̪aːsɵŋkɵ/
ଦି	/d̪i/
ଦିଅ	/d̪iɔ/
ଦିଅନ୍ତି	/d̪iɵnt̪i/
ଦିଅନ୍ତୁ	/d̪iɵnt̪u/
ଦିଆ	/d̪iaː/
ଦିଆଗଲା	/d̪iaːɡɵlaː/
ଦିଆଯାଇଥିଲା	/d̪iaːd͡ʒaːit̪ʰilaː/
ଦିଆଯାଏ	/d̪iaːd͡ʒaːe/
ଦିଏ	/d̪ie/
ଦିଗନ୍ତ	/d̪iɡɵnt̪ɵ/
ଦିଗରେ	/d̪iɡɵre/
ଦିନ	/d̪inɵ/
ଦିନକୁ	/d̪inɔku/
ଦିନଟି	/d̪inɔʈi/
ଦିନଯାକ	/d̪inɔd͡ʒaːkɔ/
ଦିନରେ	/d̪inɵre/
ଦିନସାରା	/d̪inɔsaːraː/
ଦିନେ	/d̪ine/
ଦିବସ	/d̪ibɵsɵ/
ଦିଲ୍ଲୀ	/d̪illi/
ଦିଲ୍ଲୀରେ	/d̪illire/
ଦିୱାନ୍	/d̪iuaːn/
ଦିଶନ୍ତି	/d̪isɔnt̪i/
ଦିଶନ୍ତେ	/d̪isɔnt̪e/
ଦିଶିଲା	/d̪isilaː/
ଦିଶୁ	/d̪isu/
ଦିଶୁଛୁ	/d̪isut͡ʃʰu/
ଦିଶୁଥାନ୍ତି	/d̪isut̪ʰaːnt̪i/
ଦିଶୁଥିବା	/d̪isut̪ʰibaː/
ଦିଶୁଥିଲା	/d̪isut̪ʰilaː/
ଦିଶୁଥିଲେ	/d̪isut̪ʰile/
ଦିଶେ	/d̪ise/
ଦୀପ	/d̪ipɔ/
ଦୀପାବଳି	/d̪ipaːbɔl̪i/
ଦୀର୍ଘ	/d̪irɡʱɵ/
ଦୁଇ	/d̪ui/
ଦୁଇଗୋଡ଼କୁ	/d̪uigoɽɔku/
ଦୁଇଜଣ	/d̪uid͡ʒɔɳɔ/
ଦୁଇଜଣକର	/d̪uid͡ʒɔɳɔkɔɾɔ/
ଦୁଇଜଣଙ୍କୁ	/d̪uid͡ʒɔɳɔŋku/
ଦୁଇଟି	/d̪uiʈi/
ଦୁଇଦିନ	/d̪uid̪inɔ/
ଦୁଇପଟକୁ	/d̪uipɔʈɔku/
ଦୁଇପଟୁ	/d̪uipɔʈu/
ଦୁଇମିନିଟ୍‌	/d̪uiminiʈ/
ଦୁଃଖକୁ	/d̪uhkʰɔku/
ଦୁଃଖରେ	/d̪uhkʰɔre/
ଦୁଃଖି	/d̪uhkʰi/
ଦୁଃଖିତ	/d̪uhkʰit̪ɔ/
ଦୁଃଖୀ	/d̪uhkʰi/
ଦୁଧ	/d̪ud̪ʱɔ/
ଦୁଧରେ	/d̪ud̪ʱɔre/
ଦୁମଦୁମ୍	/d̪umɔd̪um/
ଦୁରରେ	/d̪uɾɔre/
ଦୁର୍ଗ	/d̪urɡɵ/
ଦୁର୍ଗର	/d̪urɡɔɾɔ/
ଦୁର୍ଗା	/d̪urgaː/
ଦୁର୍ବଳ	/d̪urbɵl̪ɵ/
ଦୁଷ୍ଟ	/d̪usʈɔ/
ଦୁଷ୍ଟାମି	/d̪usʈaːmi/
ଦୁଷ୍ଟାମୀ	/d̪usʈaːmi/
ଦୁଃସାହସ	/d̪uhsaːhɔsɔ/
ଦୁହାଁ	/d̪uhaː̃/
ଦୁହିଁଙ୍କୁ	/d̪uhĩŋku/
ଦୁହେଁ	/d̪uhẽ/
ଦୂର	/d̪uɾɵ/
ଦୂରକୁ	/d̪uɾɔku/
ଦୂରତା	/d̪uɾɵt̪aː/
ଦୂରରୁ	/d̪uɾɔru/
ଦୂରରେ	/d̪uɾɵre/
ଦୂରାବସ୍ଥା	/d̪uraːbɔst̪ʰaː/
ଦୃଶ୍ୟ	/d̪rusjɵ/
ଦୃଷ୍ଟି	/d̪rusʈi/
ଦେ	/d̪e/
ଦେଇ	/d̪ei/
ଦେଇଛନ୍ତି	/d̪eit͡ʃʰɵnt̪i/
ଦେଇଛି	/d̪eit͡ʃʰi/
ଦେଇଥାଏ	/d̪eit̪ʰaːe/
ଦେଇଥିଲା	/d̪eit̪ʰilaː/
ଦେଇଥିଲେ	/d̪eit̪ʰile/
ଦେଇଦିଅ	/d̪eid̪iɔ/
ଦେଇଦେଲା	/d̪eid̪elaː/
ଦେଇଦେଲେ	/d̪eid̪ele/
ଦେଇପାରନ୍ତି	/d̪eipaːɾɔnt̪i/
ଦେଉ	/d̪eu/
ଦେଉଛି	/d̪eut͡ʃʰi/
ଦେଉଥିଲେ	/d̪eut̪ʰile/
ଦେଉଳ	/d̪eul̪ɵ/
ଦେଓ	/d̪eo/
ଦେଖ	/d̪ekʰɔ/
ଦେଖନ୍ତି	/d̪ekʰɔnt̪i/
ଦେଖନ୍ତୁ	/d̪ekʰɵnt̪u/
ଦେଖା	/d̪ekʰaː/
ଦେଖାଇ	/d̪ekʰaːi/
ଦେଖାଇଲେ	/d̪ekʰaːile/
ଦେଖାଏ	/d̪ekʰaːe/
ଦେଖାଓ	/d̪ekʰaːo/
ଦେଖାଗଲା	/d̪ekʰaːɡɔlaː/
ଦେଖାଯାଉଛନ୍ତି	/d̪ekʰaːd͡ʒaːut͡ʃʰɔnt̪i/
ଦେଖାଯାଉଛି	/d̪ekʰaːd͡ʒaːut͡ʃʰi/
ଦେଖାଯାଏ	/d̪ekʰaːd͡ʒaːe/
ଦେଖାଯାନ୍ତି	/d̪ekʰaːd͡ʒaːnt̪i/
ଦେଖାଯିବେ	/d̪ekʰaːd͡ʒibe/
ଦେଖି	/d̪ekʰi/
ଦେଖିଛି	/d̪ekʰit͡ʃʰi/
ଦେଖିଥିବ	/d̪ekʰit̪ʰibɔ/
ଦେଖିଥିଲା	/d̪ekʰit̪ʰilaː/
ଦେଖିନଥିଲା	/d̪ekʰinɔt̪ʰilaː/
ଦେଖିପାରିବ	/d̪ekʰipaːribɔ/
ଦେଖିପାରିବେ	/d̪ekʰipaːribe/
ଦେଖିପାରେନି	/d̪ekʰipaːreni/
ଦେଖିବା	/d̪ekʰibaː/
ଦେଖିବାକୁ	/d̪ekʰibaːku/
ଦେଖିବି	/d̪ekʰibi/
ଦେଖିବିନି	/d̪ekʰibini/
ଦେଖିବୁ	/d̪ekʰibu/
ଦେଖିଲ	/d̪ekʰilɔ/
ଦେଖିଲା	/d̪ekʰilaː/
ଦେଖିଲି	/d̪ekʰili/
ଦେଖିଲୁ	/d̪ekʰilu/
ଦେଖିଲେ	/d̪ekʰile/
ଦେଖିସାରିଥିଲା	/d̪ekʰisaːrit̪ʰilaː/
ଦେଖୁ	/d̪ekʰu/
ଦେଖୁଛନ୍ତି	/d̪ekʰut͡ʃʰɔnt̪i/
ଦେଖୁଛି	/d̪ekʰut͡ʃʰi/
ଦେଖୁଥା	/d̪ekʰut̪ʰaː/
ଦେଖୁଥାଏ	/d̪ekʰut̪ʰaːe/
ଦେଖୁଥିଲା	/d̪ekʰut̪ʰilaː/
ଦେଖୁଥିଲି	/d̪ekʰut̪ʰili/
ଦେଖୁଥିଲେ	/d̪ekʰut̪ʰile/
ଦେଖେ	/d̪ekʰe/
ଦେଖେଇ	/d̪ekʰei/
ଦେଖେଇଲା	/d̪ekʰeilaː/
ଦେଖ୍	/d̪ekʰ/
ଦେବ	/d̪ebɵ/
ଦେବଗଡ଼	/d̪ebɵɡɵɖɵ/
ଦେବଙ୍କ	/d̪ebɵŋkɵ/
ଦେବତା	/d̪ebɵt̪aː/
ଦେବା	/d̪ebaː/
ଦେବାକୁ	/d̪ebaːku/
ଦେବି	/d̪ebi/
ଦେବୀ	/d̪ebi/
ଦେବୀଙ୍କ	/d̪ebiŋkɵ/
ଦେବୁ	/d̪ebu/
ଦେବେ	/d̪ebe/
ଦେବେନି	/d̪ebeni/
ଦେଲା	/d̪elaː/
ଦେଲି	/d̪eli/
ଦେଲେ	/d̪ele/
ଦେଶ	/d̪esɵ/
ଦେଶର	/d̪esɵɾɵ/
ଦେଶରୁ	/d̪esɔru/
ଦେଶରେ	/d̪esɵre/
ଦେହ	/d̪ehɵ/
ଦେହକୁ	/d̪ehɔku/
ଦେହର	/d̪ehɵɾɵ/
ଦେହରେ	/d̪ehɵre/
ଦେହସାରା	/d̪ehɔsaːraː/
ଦେହାନ୍ତ	/d̪ehaːnt̪ɵ/
ଦୈନିକ	/d̪ɵinikɵ/
ଦୋକାନ	/d̪okaːnɔ/
ଦୋକାନକୁ	/d̪okaːnɔku/
ଦୋକାନଟିକୁ	/d̪okaːnɔʈiku/
ଦୋକାନର	/d̪okaːnɔɾɔ/
ଦୋକାନରୁ	/d̪okaːnɔru/
ଦୋକାନରେ	/d̪okaːnɔre/
ଦୋକାନସବୁ	/d̪okaːnɔsɔbu/
ଦୋକାନି	/d̪okaːni/
ଦୋକାନୀକୁ	/d̪okaːniku/
ଦୋଳ	/d̪ol̪ɵ/
ଦୋଳି	/d̪ol̪i/
ଦୋଳିଟିଏ	/d̪ol̪iʈie/
ଦୋଷ	/d̪osɵ/
ଦୌଡ଼	/d̪ɔuɽɔ/
ଦୌଡ଼ା	/d̪ɔuɽaː/
ଦୌଡ଼ାଇଲା	/d̪ɔuɽaːilaː/
ଦୌଡ଼ି	/d̪ɔuɽi/
ଦୌଡିଆସି	/d̪ɔuɖiaːsi/
ଦୌଡ଼ିକରି	/d̪ɔuɽikɔri/
ଦୌଡ଼ିକି	/d̪ɔuɽiki/
ଦୌଡ଼ିଗଲା	/d̪ɔuɽiɡɔlaː/
ଦୌଡ଼ିବାକୁ	/d̪ɔuɽibaːku/
ଦୌଡିଯାଇ	/d̪ɔuɖid͡ʒaːi/
ଦୌଡ଼ିଯାଇ	/d̪ɔuɽid͡ʒaːi/
ଦୌଡ଼ିଲା	/d̪ɔuɽilaː/
ଦୌଡ଼ିଲି	/d̪ɔuɽili/
ଦୌଡ଼ିଲେ	/d̪ɔuɽile/
ଦୌଡୁ	/d̪ɔuɖu/
ଦୌଡୁଥିଲା	/d̪ɔuɖut̪ʰilaː/
ଦ୍ବାରା	/d̪baːraː/
ଦ୍ରବ୍ୟ	/d̪ɾɵbjɵ/
ଦ୍ରଷ୍ଟବ୍ୟ	/d̪ɾɵsʈɵbjɵ/
ଦ୍ଵାର	/d̪uaːɾɵ/
ଦ୍ଵାରରେ	/d̪uaːɾɔre/
ଦ୍ଵାରା	/d̪uaːraː/
ଦ୍ଵିତୀୟ	/d̪uit̪ijɵ/
ଦ୍ଵୀପପୁଞ୍ଜ	/d̪uipɵpuɲd͡ʒɵ/
ଦ୍ୱାରା	/d̪uaːraː/
ଦ୍ୱିତୀୟ	/d̪uit̪ijɵ/
ଧକ୍‌	/d̪ʱɔk/
ଧକ୍‌-ଧକ୍‌	/d̪ʱɔk-d̪ʱɔk/
ଧକ୍କା	/d̪ʱɔkkaː/
ଧନ	/d̪ʱɵnɵ/
ଧନିଆ	/d̪ʱɔniaː/
ଧନୀ	/d̪ʱɔni/
ଧନୀକୁ	/d̪ʱɔniku/
ଧନୀଜୀ	/d̪ʱɔnid͡ʒi/
ଧନୀଜୀଙ୍କର	/d̪ʱɔnid͡ʒiŋkɔɾɔ/
ଧନୁ	/d̪ʱɵnu/
ଧନ୍ଦା	/d̪ʱɔnd̪aː/
ଧନ୍ଦି	/d̪ʱɔnd̪i/
ଧନ୍ୟବାଦ	/d̪ʱɵnjɵbaːd̪ɵ/
ଧନ୍ୟବାଦ୍	/d̪ʱɔnjɔbaːd̪/
ଧପ୍	/d̪ʱɔp/
ଧମ	/d̪ʱɔmɔ/
ଧରଣର	/d̪ʱɵɾɵɳɵɾɵ/
ଧରନ୍ତି	/d̪ʱɔɾɔnt̪i/
ଧରି	/d̪ʱɵri/
ଧରିଛି	/d̪ʱɔrit͡ʃʰi/
ଧରିତ୍ରୀ	/d̪ʱɵrit̪ri/
ଧରିନେଇଥିଲା	/d̪ʱɔrineit̪ʰilaː/
ଧରିବା	/d̪ʱɵribaː/
ଧରିବାକୁ	/d̪ʱɔribaːku/
ଧରିବି	/d̪ʱɔribi/
ଧରିଲା	/d̪ʱɔrilaː/
ଧରିଲାଣି	/d̪ʱɔrilaːɳi/
ଧରିଲେ	/d̪ʱɔrile/
ଧରୁଥିବା	/d̪ʱɔrut̪ʰibaː/
ଧର୍ମ	/d̪ʱɵrmɵ/
ଧର୍ମପିତା	/d̪ʱɔrmɔpit̪aː/
ଧର୍ମର	/d̪ʱɵrmɵɾɵ/
ଧଳା	/d̪ʱɵl̪aː/
ଧଳାମେଘ	/d̪ʱɔl̪aːmeɡʱɔ/
ଧାଇଁ	/d̪ʱaːĩ/
ଧାଇଁଲା	/d̪ʱaːĩlaː/
ଧାଇଁଲେ	/d̪ʱaːĩle/
ଧାଉଁଥିଲା	/d̪ʱaːũt̪ʰilaː/
ଧାଡ଼ି	/d̪ʱaːɽi/
ଧାଡ଼ିଏ	/d̪ʱaːɽie/
ଧାତୁ	/d̪ʱaːt̪u/
ଧାତୁରେ	/d̪ʱaːt̪ure/
ଧାନ	/d̪ʱaːnɵ/
ଧାନୀ	/d̪ʱaːni/
ଧାରଣ	/d̪ʱaːɾɵɳɵ/
ଧାରା	/d̪ʱaːraː/
ଧାର୍ମିକ	/d̪ʱaːrmikɵ/
ଧିମା	/d̪ʱimaː/
ଧିରେ	/d̪ʱire/
ଧୀମା	/d̪ʱimaː/
ଧୀର	/d̪ʱiɾɵ/
ଧୀରେ	/d̪ʱire/
ଧୁସର	/d̪ʱusɔɾɔ/
ଧୁସର-ମାଟିଆ	/d̪ʱusɔɾɔ-maːʈiaː/
ଧୂଆଁ	/d̪ʱuaː̃/
ଧୂଆଁରେ	/d̪ʱuaː̃re/
ଧୂପ	/d̪ʱupɵ/
ଧୂପକାଠି	/d̪ʱupɔkaːʈʰi/
ଧୂର୍ତ୍ତ	/d̪ʱurt̪t̪ɔ/
ଧୂଳି	/d̪ʱul̪i/
ଧୂଳିଆ	/d̪ʱul̪iaː/
ଧୈର୍ଯ୍ୟର	/d̪ʱɔird͡ʒjɔɾɔ/
ଧୋବା	/d̪ʱobaː/
ଧୋବାଙ୍କୁ	/d̪ʱobaːŋku/
ଧ୍ୟାନମଗ୍ନ	/d̪ʱjaːnɔmɔgnɔ/
ନଅ	/nɔɔ/
ନଅର	/nɔɔɾɔ/
ନଇଁ	/nɔĩ/
ନଇଁକି	/nɔĩki/
ନଈକୂଳରେ	/nɔikul̪ɔre/
ନଈରେ	/nɔire/
ନକଲ୍	/nɔkɔl/
ନକ୍ଷତ୍ର	/nɵkʰjɵt̪ɾɵ/
ନଖାଇ	/nɔkʰaːi/
ନଗର	/nɵɡɵɾɵ/
ନଚେଇବାରେ	/nɔt͡ʃeibaːre/
ନଡ଼ିଆ	/nɔɽiaː/
ନଡ଼ିଆ	/nɵɽiaː/
ନଡ଼ିଆଟେ	/nɔɽiaːʈe/
ନଥାନ୍ତା	/nɔt̪ʰaːnt̪aː/
ନଥାନ୍ତି	/nɔt̪ʰaːnt̪i/
ନଥାନ୍ତେ	/nɔt̪ʰaːnt̪e/
ନଥିବା	/nɵt̪ʰibaː/
ନଥିବାରୁ	/nɔt̪ʰibaːru/
ନଥିଲା	/nɵt̪ʰilaː/
ନଥିଲି	/nɔt̪ʰili/
ନଥିଲୁ	/nɔt̪ʰilu/
ନଥିଲେ	/nɵt̪ʰile/
ନଦୀ	/nɵd̪i/
ନଦୀକୂଳକୁ	/nɔd̪ikul̪ɔku/
ନନ୍ଦ	/nɵnd̪ɵ/
ନନ୍ଦୀ	/nɔnd̪i/
ନବମ	/nɵbɵmɵ/
ନବମୀ	/nɵbɵmi/
ନବରଙ୍ଗପୁର	/nɵbɵɾɵŋɡɵpuɾɵ/
ନବରାତ୍ରୀ	/nɔbɔraːt̪ri/
ନବୀନ	/nɵbinɵ/
ନଭେମ୍ବର	/nɵbʱembɵɾɵ/
ନମ୍ବର	/nɵmbɵɾɵ/
ନମ୍ବର୍	/nɔmbɔr/
ନୟାଗଡ଼	/nɵjaːɡɵɖɵ/
ନରମ	/nɔɾɔmɔ/
ନରସିଂହ	/nɵɾɵsiŋhɵ/
ନରେନ୍ଦ୍ର	/nɵrend̪ɾɵ/
ନର୍ସୀ	/nɔrsi/
ନଳୀ	/nɵl̪i/
ନଷ୍ଟ	/nɵsʈɵ/
ନଷ୍ଟକାରୀ	/nɔsʈɔkaːri/
ନହେଲେ	/nɔhele/
ନା	/naː/
ନାଁ	/naː̃/
ନାଆଁ	/naːaː̃/
ନାଆଁରେ	/naːaː̃re/
ନାଇଁ	/naːĩ/
ନାକ	/naːkɵ/
ନାକକିଛି	/naːkɔkit͡ʃʰi/
ନାକକୁ	/naːkɔku/
ନାକଟା	/naːkɔʈaː/
ନାକଟି	/naːkɔʈi/
ନାକର	/naːkɔɾɔ/
ନାକରେ	/naːkɔre/
ନାଗ	/naːɡɵ/
ନାଗରା	/naːɡɔraː/
ନାଚ	/naːt͡ʃɵ/
ନାଚି	/naːt͡ʃi/
ନାଚିପାରେ	/naːt͡ʃipaːre/
ନାଚିବା	/naːt͡ʃibaː/
ନାଚିବି	/naːt͡ʃibi/
ନାଚିଲା	/naːt͡ʃilaː/
ନାଚୁଥିବାର	/naːt͡ʃut̪ʰibaːɾɔ/
ନାଚୁଥିଲେ	/naːt͡ʃut̪ʰile/
ନାଚେ	/naːt͡ʃe/
ନାଟ	/naːʈɵ/
ନାଟକ	/naːʈɵkɵ/
ନାଟ୍ୟକାର	/naːʈjɵkaːɾɵ/
ନାଡ଼ିର	/naːɽiɾɔ/
ନାଡୁରେ	/naːɖure/
ନାତି	/naːt̪i/
ନାଥ	/naːt̪ʰɵ/
ନାନ	/naːnɔ/
ନାନା	/naːnaː/
ନାନାଦି	/naːnaːd̪i/
ନାନି	/naːni/
ନାପସନ୍ଦ	/naːpɔsɔnd̪ɔ/
ନାବିକ	/naːbikɔ/
ନାମ	/naːmɵ/
ନାମକ	/naːmɵkɵ/
ନାମକରଣ	/naːmɵkɵɾɵɳɵ/
ନାମରେ	/naːmɵre/
ନାମିତ	/naːmit̪ɵ/
ନାୟକ	/naːjɵkɵ/
ନାରଂଗୀ	/naːɾɔŋgi/
ନାରାୟଣ	/naːraːjɵɳɵ/
ନାରୀ	/naːri/
ନାଲି	/naːli/
ନାଳକୁ	/naːl̪ɔku/
ନାହଁ	/naːhɔ̃/
ନାହାନ୍ତି	/naːhaːnt̪i/
ନାହାଁନ୍ତି	/naːhaː̃nt̪i/
ନାହିଁ	/naːhĩ/
ନାହିଁକି	/naːhĩki/
ନାହୁଁ	/naːhũ/
ନିଅ	/niɔ/
ନିଅନ୍ତି	/niɔnt̪i/
ନିଅନ୍ତୁ	/niɔnt̪u/
ନିଆଁ	/niaː̃/
ନିଆଯାଏ	/niaːd͡ʒaːe/
ନିଆଁରେ	/niaː̃re/
ନିଉଲଣ୍ଡନ	/niulɔɳɖɔnɔ/
ନିଏ	/nie/
ନିକଟ	/nikɔʈɔ/
ନିକଟରେ	/nikɵʈɵre/
ନିକଟସ୍ଥ	/nikɵʈɵst̪ʰɵ/
ନିଗମ	/niɡɵmɵ/
ନିଘୋଡ଼	/nigʰoɽɔ/
ନିଜ	/nid͡ʒɵ/
ନିଜଉପରେ	/nid͡ʒɔupɔre/
ନିଜକଥା	/nid͡ʒɔkɔt̪ʰaː/
ନିଜକୁ	/nid͡ʒɵku/
ନିଜନିଜର	/nid͡ʒɔnid͡ʒɔɾɔ/
ନିଜପାଇଁ	/nid͡ʒɔpaːĩ/
ନିଜର	/nid͡ʒɵɾɵ/
ନିଜେ	/nid͡ʒe/
ନିତାଇ	/nit̪aːi/
ନିତାନ୍ତ	/nit̪aːnt̪ɔ/
ନିଦ	/nid̪ɔ/
ନିଦରୁ	/nid̪ɔru/
ନିଦରେ	/nid̪ɔre/
ନିଦୁଆ	/nid̪uaː/
ନିମନ୍ତେ	/nimɵnt̪e/
ନିମନ୍ତ୍ରଣ	/nimɔnt̪ɾɔɳɔ/
ନିମୋନିଆ	/nimoniaː/
ନିମ୍ନ	/nimnɵ/
ନିମ୍ବ	/nimbɔ/
ନିଯୁକ୍ତ	/nid͡ʒukt̪ɵ/
ନିଯୁକ୍ତି	/nid͡ʒukt̪i/
ନିୟନ୍ତ୍ରଣ	/nijɵnt̪ɾɵɳɵ/
ନିୟମ	/nijɵmɵ/
ନିୟମିତ	/nijɵmit̪ɵ/
ନିୟୁତ	/nijut̪ɵ/
ନିରନ୍ତର	/niɾɔnt̪ɔɾɔ/
ନିରବ	/niɾɔbɔ/
ନିରସ	/niɾɔsɔ/
ନିରାପଦରେ	/niraːpɔd̪ɔre/
ନିରୀକ୍ଷଣ	/nirikʰjɔɳɔ/
ନିରୁତ୍ସାହ	/nirut̪saːhɔ/
ନିର୍ଜନ	/nird͡ʒɔnɔ/
ନିର୍ଜୀବ	/nird͡ʒibɔ/
ନିର୍ଣ୍ଣୟ	/nirɳɳɵjɵ/
ନିର୍ଦ୍ଦିଷ୍ଟ	/nird̪d̪isʈɵ/
ନିର୍ଦ୍ଦେଶକ	/nird̪d̪esɵkɵ/
ନିର୍ଦ୍ଦେଶନା	/nird̪d̪esɵnaː/
ନିର୍ଦ୍ଦେଶନାରେ	/nird̪d̪esɵnaːre/
ନିର୍ବାଚନ	/nirbaːt͡ʃɵnɵ/
ନିର୍ବାଚନମଣ୍ଡଳୀ	/nirbaːt͡ʃɵnɵmɵɳɖɵl̪i/
ନିର୍ବାଚନମଣ୍ଡଳୀରୁ	/nirbaːt͡ʃɵnɵmɵɳɖɵl̪iru/
ନିର୍ବାଚନରେ	/nirbaːt͡ʃɵnɵre/
ନିର୍ବାଚିତ	/nirbaːt͡ʃit̪ɵ/
ନିର୍ଭର	/nirbʰɵɾɵ/
ନିର୍ମଳ	/nirmɔl̪ɔ/
ନିର୍ମାଣ	/nirmaːɳɵ/
ନିର୍ମାତା	/nirmaːt̪aː/
ନିର୍ମିତ	/nirmit̪ɵ/
ନିଶ	/nisɔ/
ନିଶକୁ	/nisɔku/
ନିଶଥିବା	/nisɔt̪ʰibaː/
ନିଶୁଆ	/nisuaː/
ନିଶୁଣୀ	/nisuɳi/
ନିଶ୍ଚୟ	/nist͡ʃɔjɔ/
ନିଶ୍ଚିତ	/nist͡ʃit̪ɔ/
ନିଶ୍ଚେ	/nist͡ʃe/
ନିଶ୍ୱାସ	/nisuaːsɔ/
ନିଃଶ୍ୱାସକୁ	/nihsuaːsɔku/
ନିଃଶ୍ୱାସର	/nihsuaːsɔɾɔ/
ନୀତି	/nit̪i/
ନୀଳ	/nil̪ɵ/
ନୀଳଗିରି	/nil̪ɵgiri/
ନୀଳମଣି	/nil̪ɵmɵɳi/
ନୀଳରଙ୍ଗର	/nil̪ɔɾɔŋɡɔɾɔ/
ନୀଳରର	/nil̪ɔɾɔɾɔ/
ନୁଆ	/nuaː/
ନୁଆଇଁ	/nuaːĩ/
ନୁହଁ	/nuhɔ̃/
ନୁହଁକି	/nuhɔ̃ki/
ନୁହନ୍ତି	/nuhɔnt̪i/
ନୁହେଁ	/nuhẽ/
ନୂଆ	/nuaː/
ନୂଆଁ	/nuaː̃/
ନୂଆପଡ଼ା	/nuaːpɵɽaː/
ନୂଆସହର	/nuaːsɔhɔɾɔ/
ନୂତନ	/nut̪ɵnɵ/
ନୃତ୍ୟ	/nrut̪jɵ/
ନୃସିଂହ	/nrusiŋhɵ/
ନେଇ	/nei/
ନେଇଆସି	/neiaːsi/
ନେଇଆସିବୁ	/neiaːsibu/
ନେଇକି	/neiki/
ନେଇଗଲା	/neiɡɔlaː/
ନେଇଗଲେ	/neiɡɔle/
ନେଇଛନ୍ତି	/neit͡ʃʰɔnt̪i/
ନେଇଥାନ୍ତି	/neit̪ʰaːnt̪i/
ନେଇଥିଲେ	/neit̪ʰile/
ନେଇଯାନ୍ତି	/neid͡ʒaːnt̪i/
ନେଇଯିବାକୁ	/neid͡ʒibaːku/
ନେଉ	/neu/
ନେଉଥିଲା	/neut̪ʰilaː/
ନେଉଥିଲେ	/neut̪ʰile/
ନେତା	/net̪aː/
ନେପାଳ	/nepaːl̪ɵ/
ନେବ	/nebɔ/
ନେବତ	/nebɔt̪ɔ/
ନେବା	/nebaː/
ନେବାକୁ	/nebaːku/
ନେବି	/nebi/
ନେଲା	/nelaː/
ନେଲେ	/nele/
ନେଳି	/nel̪i/
ନୈଶିନ	/nɔisinɔ/
ନୋବେଲ	/nobelɵ/
ନୌକା	/nɔukaː/
ନୌକାକୁ	/nɔukaːku/
ନୌକାଟି	/nɔukaːʈi/
ନୌକାଟେ	/nɔukaːʈe/
ନୌକାଠୁ	/nɔukaːʈʰu/
ନୌକାଭଳି	/nɔukaːbʰɔl̪i/
ନୌକାର	/nɔukaːɾɔ/
ନୌକାରେ	/nɔukaːre/
ନ୍ତି	/nt̪i/
ନ୍ୟାପ୍	/njaːp/
ପଇସା	/pɵisaː/
ପକଉଛି	/pɔkɔut͡ʃʰi/
ପକାଅ	/pɔkaːɔ/
ପକାଇ	/pɵkaːi/
ପକାଇଥାନ୍ତି	/pɔkaːit̪ʰaːnt̪i/
ପକାଇଦିଅ	/pɔkaːid̪iɔ/
ପକାଇବ	/pɔkaːibɔ/
ପକାଇବା	/pɵkaːibaː/
ପକାଇବାକୁ	/pɔkaːibaːku/
ପକାଇଲା	/pɔkaːilaː/
ପକାଇଲି	/pɔkaːili/
ପକାଇଲେ	/pɔkaːile/
ପକାଏ	/pɔkaːe/
ପକୁଡି	/pɔkuɖi/
ପକୁଡ଼ି	/pɔkuɽi/
ପକୃତରେ	/pɔkrut̪ɔre/
ପକେଇକି	/pɔkeiki/
ପକେଇବା	/pɵkeibaː/
ପକେଇଲା	/pɔkeilaː/
ପକେଟରୁ	/pɔkeʈɔru/
ପକ୍ଷ	/pɵkʰjɵ/
ପକ୍ଷରୁ	/pɵkʰjɵru/
ପକ୍ଷୀ	/pɵkʰi/
ପକ୍ଷେ	/pɔkʰe/
ପଖାଳ	/pɵkʰaːl̪ɵ/
ପଗଡ଼ି	/pɔɡɔɽi/
ପଗଡ଼ିକୁ	/pɔɡɔɽiku/
ପଗଡ଼ିଟି	/pɔɡɔɽiʈi/
ପଗଡ଼ିଟିଏ	/pɔɡɔɽiʈie/
ପଗଡ଼ିରେ	/pɔɡɔɽire/
ପଚାକାଠ	/pɔt͡ʃaːkaːʈʰɔ/
ପଚାରି	/pɔt͡ʃaːri/
ପଚାରିବା	/pɔt͡ʃaːribaː/
ପଚାରିବି	/pɔt͡ʃaːribi/
ପଚାରିଲା	/pɔt͡ʃaːrilaː/
ପଚାରିଲି	/pɔt͡ʃaːrili/
ପଚାରିଲେ	/pɔt͡ʃaːrile/
ପଚାରୁନଥିଲେ	/pɔt͡ʃaːrunɔt̪ʰile/
ପଚାରେ	/pɔt͡ʃaːre/
ପଚାଶପଟ	/pɔt͡ʃaːsɔpɔʈɔ/
ପଛ	/pɔt͡ʃʰɔ/
ପଛକୁ	/pɔt͡ʃʰɔku/
ପଛଗୋଡ଼ରେ	/pɔt͡ʃʰɔgoɽɔre/
ପଛରେ	/pɵt͡ʃʰɵre/
ପଛୁଆ	/pɵt͡ʃʰuaː/
ପଛେ	/pɔt͡ʃʰe/
ପଞ୍ଚ	/pɵɲt͡ʃɵ/
ପଞ୍ଚକୁ	/pɔɲt͡ʃɔku/
ପଞ୍ଚମ	/pɵɲt͡ʃɵmɵ/
ପଞ୍ଚମୀ	/pɵɲt͡ʃɵmi/
ପଞ୍ଚାୟତ	/pɵɲt͡ʃaːjɵt̪ɵ/
ପଞ୍ଜାବ	/pɵɲd͡ʒaːbɵ/
ପଞ୍ଜାବୀ	/pɵɲd͡ʒaːbi/
ପଟ	/pɔʈɔ/
ପଟକୁ	/pɔʈɔku/
ପଟାରେ	/pɔʈaːre/
ପଟି	/pɔʈi/
ପଟିକୁ	/pɔʈiku/
ପଟିଟି	/pɔʈiʈi/
ପଟିଟିଏ	/pɔʈiʈie/
ପଟେ	/pɵʈe/
ପଟ୍ଟନାୟକ	/pɵʈʈɵnaːjɵkɵ/
ପଠାନ୍ତି	/pɔʈʰaːnt̪i/
ପଠେଇ	/pɔʈʰei/
ପଠେଇଛି	/pɔʈʰeit͡ʃʰi/
ପଡ଼	/pɔɽɔ/
ପଡ଼ି	/pɔɽi/
ପଡ଼ିଆ	/pɔɽiaː/
ପଡ଼ିଆଟେ	/pɔɽiaːʈe/
ପଡିଆରେ	/pɔɖiaːre/
ପଡ଼ିଆରେ	/pɔɽiaːre/
ପଡ଼ିଗଲା	/pɔɽiɡɔlaː/
ପଡିଗଲାଣି	/pɔɖiɡɔlaːɳi/
ପଡ଼ିଛି	/pɔɽit͡ʃʰi/
ପଡିଥାଏ	/pɔɖit̪ʰaːe/
ପଡ଼ିଥାଏ	/pɔɽit̪ʰaːe/
ପଡ଼ିଥିବା	/pɔɽit̪ʰibaː/
ପଡ଼ିଥିଲା	/pɔɽit̪ʰilaː/
ପଡ଼ିନାହିଁ	/pɔɽinaːhĩ/
ପଡିବ	/pɔɖibɔ/
ପଡ଼ିବ	/pɔɽibɔ/
ପଡ଼ିବ	/pɵɽibɵ/
ପଡ଼ିବନି	/pɔɽibɔni/
ପଡ଼ିବା	/pɔɽibaː/
ପଡ଼ିବା	/pɵɽibaː/
ପଡିବି	/pɔɖibi/
ପଡ଼ିବେ	/pɔɽibe/
ପଡ଼ିଯାଇଥିଲା	/pɔɽid͡ʒaːit̪ʰilaː/
ପଡିଯାଏ	/pɔɖid͡ʒaːe/
ପଡ଼ିଯାଏ	/pɔɽid͡ʒaːe/
ପଡିଲା	/pɔɖilaː/
ପଡ଼ିଲା	/pɔɽilaː/
ପଡିଲେ	/pɔɖile/
ପଡ଼ିଲେ	/pɔɽile/
ପଡ଼ିଶାଘର	/pɔɽisaːɡʱɔɾɔ/
ପଡ଼ୁ	/pɔɽu/
ପଡ଼ୁଛି	/pɔɽut͡ʃʰi/
ପଡ଼ୁଥିବ	/pɔɽut̪ʰibɔ/
ପଡ଼ୁଥିଲା	/pɔɽut̪ʰilaː/
ପଡ଼େ	/pɔɽe/
ପଡେ	/pɵɖe/
ପଡ଼େ	/pɵɽe/
ପଡେନାହିଁ	/pɔɖenaːhĩ/
ପଡ଼ୋଶୀ	/pɔɽosi/
ପଢ଼	/pɔɽʱɔ/
ପଢନ୍ତୁ	/pɵɖʱɵnt̪u/
ପଢ଼ନ୍ତୁ	/pɵɖʱɵnt̪u/
ପଢ଼ା	/pɔɽʱaː/
ପଢ଼ାଇଲେ	/pɔɽʱaːile/
ପଢ଼ି	/pɔɽʱi/
ପଢ଼ିପାରୁଛ	/pɔɽʱipaːrut͡ʃʰɔ/
ପଢ଼ିବା	/pɔɽʱibaː/
ପଢ଼ିବାକୁ	/pɔɽʱibaːku/
ପଢ଼ିଲୁ	/pɔɽʱilu/
ପଢ଼ିଲେ	/pɔɽʱile/
ପଢ଼ିଲେଣି	/pɔɽʱileɳi/
ପଢ଼ୁ	/pɔɽʱu/
ପଢ଼ୁଛନ୍ତି	/pɔɽʱut͡ʃʰɔnt̪i/
ପଢୁଥିଲା	/pɔɖʱut̪ʰilaː/
ପଢ଼ୁଥିଲେ	/pɔɽʱut̪ʰile/
ପଢ଼େ	/pɔɽʱe/
ପଣା	/pɵɳaː/
ପଣ୍ଡା	/pɵɳɖaː/
ପଣ୍ଡିତ	/pɵɳɖit̪ɵ/
ପତନ	/pɔt̪ɔnɔ/
ପତଳା	/pɔt̪ɔl̪aː/
ପତାକା	/pɵt̪aːkaː/
ପତି	/pɵt̪i/
ପତ୍ନୀ	/pɵt̪ni/
ପତ୍ର	/pɵt̪ɾɵ/
ପତ୍ରକୁ	/pɵt̪ɾɵku/
ପତ୍ରମାନେ	/pɔt̪ɾɔmaːne/
ପତ୍ରିକା	/pɵt̪rikaː/
ପଥ	/pɵt̪ʰɵ/
ପଥର	/pɵt̪ʰɵɾɵ/
ପଥରକୁ	/pɔt̪ʰɔɾɔku/
ପଥରମାନ	/pɔt̪ʰɔɾɔmaːnɔ/
ପଥରରେ	/pɔt̪ʰɔɾɔre/
ପଦ	/pɵd̪ɵ/
ପଦକ	/pɵd̪ɵkɵ/
ପଦଯାତ୍ରା	/pɔd̪ɔd͡ʒaːt̪raː/
ପଦଯାତ୍ରାରେ	/pɔd̪ɔd͡ʒaːt̪raːre/
ପଦଯାତ୍ରୀର	/pɔd̪ɔd͡ʒaːt̪riɾɔ/
ପଦାର୍ଥ	/pɵd̪aːrt̪ʰɵ/
ପଦ୍ଧତି	/pɵd̪d̪ʱɵt̪i/
ପଦ୍ମ	/pɵd̪mɵ/
ପଦ୍ମଶ୍ରୀ	/pɵd̪mɵsri/
ପବନ	/pɵbɵnɵ/
ପବିତ୍ର	/pɵbit̪ɾɵ/
ପର	/pɵɾɵ/
ପରଖିନେବେ	/pɵɾɵkʰinebe/
ପରଗ	/pɔɾɔɡɔ/
ପରଟା	/pɔɾɔʈaː/
ପରଠା	/pɔɾɔʈʰaː/
ପରଠୁ	/pɔɾɔʈʰu/
ପରତ	/pɔɾɔt̪ɔ/
ପରତରେ	/pɔɾɔt̪ɔre/
ପରଦିନ	/pɔɾɔd̪inɔ/
ପରପୃଷ୍ଠା	/pɔɾɔprusʈʰaː/
ପରବର୍ତ୍ତୀ	/pɵɾɵbɵrt̪t̪i/
ପରମ	/pɵɾɵmɵ/
ପରମହଂସ	/pɵɾɵmɵhɵŋsɵ/
ପରମାଣୁ	/pɵɾɵmaːɳu/
ପରମ୍ପରା	/pɵɾɵmpɵraː/
ପରଯୁକ୍ତ	/pɔɾɔd͡ʒukt̪ɔ/
ପରର	/pɔɾɔɾɔ/
ପରଶି	/pɔɾɔsi/
ପରଶିବା	/pɔɾɔsibaː/
ପରସ୍ପର	/pɔɾɔspɔɾɔ/
ପରସ୍ପରକୁ	/pɔɾɔspɔɾɔku/
ପରସ୍ପରର	/pɔɾɔspɔɾɔɾɔ/
ପରାଗ	/pɔraːɡɔ/
ପରାପ୍ପୁ	/pɔraːppu/
ପରାମର୍ଶ	/pɵraːmɵrsɵ/
ପରାସ୍ତ	/pɔraːst̪ɔ/
ପରି	/pɵri/
ପରିଚୟ	/pɵrit͡ʃɵjɵ/
ପରିଚାଳକ	/pɵrit͡ʃaːl̪ɵkɵ/
ପରିଚାଳନା	/pɵrit͡ʃaːl̪ɵnaː/
ପରିଚିତ	/pɵrit͡ʃit̪ɵ/
ପରିଜା	/pɵrid͡ʒaː/
ପରିଣତ	/pɵriɳɵt̪ɵ/
ପରିବର୍ତ୍ତନ	/pɵribɵrt̪t̪ɵnɵ/
ପରିବର୍ତ୍ତିତ	/pɔribɔrt̪t̪it̪ɔ/
ପରିବା	/pɔribaː/
ପରିବାବାଲା	/pɔribaːbaːlaː/
ପରିବାର	/pɵribaːɾɵ/
ପରିବାରର	/pɵribaːɾɵɾɵ/
ପରିବାରରୁ	/pɔribaːɾɔru/
ପରିବାରରେ	/pɵribaːɾɵre/
ପରିବାହକ	/pɔribaːhɔkɔ/
ପରିବେଶ	/pɵribesɵ/
ପରିବେଷଣ	/pɵribesɵɳɵ/
ପରିମାଣ	/pɵrimaːɳɵ/
ପରିମାଣର	/pɔrimaːɳɔɾɔ/
ପରିମାଣରେ	/pɵrimaːɳɵre/
ପରିରାଇଜ	/pɔriraːid͡ʒɔ/
ପରିଶ୍ରମ	/pɔrisɾɔmɔ/
ପରିଶ୍ରମରେ	/pɔrisɾɔmɔre/
ପରିଷଦ	/pɵrisɵd̪ɵ/
ପରିଷ୍କାର	/pɔriskaːɾɔ/
ପରୀ	/pɔri/
ପରୀକ୍ଷା	/pɵrikʰjaː/
ପରେ	/pɵre/
ପର୍ଦ୍ଦା	/pɔrd̪d̪aː/
ପର୍ବ	/pɵrbɵ/
ପର୍ବତ	/pɵrbɵt̪ɵ/
ପର୍ବତମାନଙ୍କୁ	/pɔrbɔt̪ɔmaːnɔŋku/
ପର୍ବପର୍ବାଣୀ	/pɵrbɵpɵrbaːɳi/
ପର୍ବାଣୀ	/pɵrbaːɳi/
ପର୍ଯ୍ୟଟନ	/pɵrd͡ʒjɵʈɵnɵ/
ପର୍ଯ୍ୟନ୍ତ	/pɵrd͡ʒjɵnt̪ɵ/
ପର୍ଯ୍ୟାପ୍ତ	/pɔrd͡ʒjaːpt̪ɔ/
ପର୍ଯ୍ୟାୟ	/pɵrd͡ʒjaːjɵ/
ପର୍ଶୁରାମ	/pɵrsuraːmɵ/
ପଲାଉ	/pɔlaːu/
ପଳାଅ	/pɔl̪aːɔ/
ପଳାଇଲା	/pɔl̪aːilaː/
ପଳାଉଥିଲେ	/pɔl̪aːut̪ʰile/
ପଳାନ୍ତି	/pɔl̪aːnt̪i/
ପଳେଇ	/pɔl̪ei/
ପଳେଇଗଲା	/pɔl̪eiɡɔlaː/
ପଳେଇଯାଅ	/pɔl̪eid͡ʒaːɔ/
ପଳେଇଲା	/pɔl̪eilaː/
ପଳେଇଲେ	/pɔl̪eile/
ପଶା	/pɔsaː/
ପଶି	/pɔsi/
ପଶିଗଲା	/pɔsiɡɔlaː/
ପଶିବାବେଳେ	/pɔsibaːbel̪e/
ପଶୁ	/pɵsu/
ପଶୁପକ୍ଷୀ	/pɔsupɔkʰi/
ପଶୁମାନଙ୍କ	/pɔsumaːnɔŋkɔ/
ପଶ୍ଚିମ	/pɵst͡ʃimɵ/
ପଶ୍ଚିମବଙ୍ଗ	/pɵst͡ʃimɵbɵŋɡɵ/
ପଶ୍ଚିମରେ	/pɵst͡ʃimɵre/
ପସନ୍ଦ	/pɵsɵnd̪ɵ/
ପସନ୍ଦର	/pɔsɔnd̪ɔɾɔ/
ପହଂଚିଗଲା	/pɔhɔŋt͡ʃiɡɔlaː/
ପହଁଚିବା	/pɔhɔ̃t͡ʃibaː/
ପହଁଚିବେ	/pɔhɔ̃t͡ʃibe/
ପହଂଚିଲେ	/pɔhɔŋt͡ʃile/
ପହଞ୍ଚାଇଲା	/pɔhɔɲt͡ʃaːilaː/
ପହଞ୍ଚି	/pɔhɔɲt͡ʃi/
ପହଞ୍ଚିଗଲି	/pɔhɔɲt͡ʃiɡɔli/
ପହଞ୍ଚିଗଲେ	/pɔhɔɲt͡ʃiɡɔle/
ପହଞ୍ଚିପାରିବା	/pɔhɔɲt͡ʃipaːribaː/
ପହଞ୍ଚିବ	/pɔhɔɲt͡ʃibɔ/
ପହଞ୍ଚିବାକୁ	/pɔhɔɲt͡ʃibaːku/
ପହଞ୍ଚିଲା	/pɔhɔɲt͡ʃilaː/
ପହଞ୍ଚିଲି	/pɔhɔɲt͡ʃili/
ପହଞ୍ଚିଲେ	/pɔhɔɲt͡ʃile/
ପହଣ୍ଡି	/pɵhɵɳɖi/
ପହଁରି	/pɔhɔ̃ri/
ପହଁରୁ	/pɔhɔ̃ru/
ପହଁରୁଥିଲେ	/pɔhɔ̃rut̪ʰile/
ପହେଲମାନ	/pɔhelɔmaːnɔ/
ପହେଲମାନର	/pɔhelɔmaːnɔɾɔ/
ପା	/paː/
ପାଆନ୍ତି	/paːaːnt̪i/
ପାଇ	/paːi/
ପାଇଁ	/paːĩ/
ପାଇକ	/paːikɔ/
ପାଇଗଲି	/paːiɡɔli/
ପାଇଛି	/paːit͡ʃʰi/
ପାଇଜାମା	/paːid͡ʒaːmaː/
ପାଇଥିଲ	/paːit̪ʰilɔ/
ପାଇଥିଲା	/paːit̪ʰilaː/
ପାଇଥିଲେ	/paːit̪ʰile/
ପାଇପାରିବ	/paːipaːribɔ/
ପାଇବା	/paːibaː/
ପାଇବୁ	/paːibu/
ପାଇବେ	/paːibe/
ପାଇଯିବା	/paːid͡ʒibaː/
ପାଇଲଟ୍	/paːilɔʈ/
ପାଇଲା	/paːilaː/
ପାଇଲାନି	/paːilaːni/
ପାଇଲି	/paːili/
ପାଇଲିନି	/paːilini/
ପାଇଲେ	/paːile/
ପାଇଲେନି	/paːileni/
ପାଇସାରିଥିଲା	/paːisaːrit̪ʰilaː/
ପାଉ	/paːu/
ପାଉଛନ୍ତି	/paːut͡ʃʰɔnt̪i/
ପାଉଡର	/paːuɖɔɾɔ/
ପାଉଥିଲେ	/paːut̪ʰile/
ପାଉନି	/paːuni/
ପାଉଁରୁଟି	/paːũruʈi/
ପାଉଁଶିଆ	/paːũsiaː/
ପାଏ	/paːe/
ପାକଶାଳାରେ	/paːkɔsaːl̪aːre/
ପାକିସ୍ତାନ	/paːkist̪aːnɵ/
ପାକୁଳି	/paːkul̪i/
ପାଖ	/paːkʰɵ/
ପାଖକୁ	/paːkʰɔku/
ପାଖରୁ	/paːkʰɔru/
ପାଖରେ	/paːkʰɵre/
ପାଖାପାଖି	/paːkʰaːpaːkʰi/
ପାଖେ	/paːkʰe/
ପାଗ	/paːɡɔ/
ପାଚିଗଲା	/paːt͡ʃiɡɔlaː/
ପାଚିଲା	/paːt͡ʃilaː/
ପାଚେର	/paːt͡ʃeɾɔ/
ପାଚେରୀ	/paːt͡ʃeri/
ପାଚେରୀରୁ	/paːt͡ʃeriru/
ପାଚେରୀରେ	/paːt͡ʃerire/
ପାଞ୍ଚ	/paːɲt͡ʃɵ/
ପାଞ୍ଚଟି	/paːɲt͡ʃɵʈi/
ପାଞ୍ଚମିନିଟ୍‌	/paːɲt͡ʃɔminiʈ/
ପାଞ୍ଜି	/paːɲd͡ʒi/
ପାଟ	/paːʈɵ/
ପାଟି	/paːʈi/
ପାଟିକରି	/paːʈikɔri/
ପାଟିକଲା	/paːʈikɔlaː/
ପାଟିକଲେ	/paːʈikɔle/
ପାଟିରୁ	/paːʈiru/
ପାଟିରେ	/paːʈire/
ପାଠ	/paːʈʰɵ/
ପାଠକ	/paːʈʰɵkɵ/
ପାଠାଗାର	/paːʈʰaːgaːɾɵ/
ପାଢ଼ୀ	/paːɽʱi/
ପାଣି	/paːɳi/
ପାଣିକଢ଼ା	/paːɳikɔɽʱaː/
ପାଣିକୁ	/paːɳiku/
ପାଣିଗାହି	/paːɳigaːhi/
ପାଣିଗ୍ରାହୀ	/paːɳigraːhi/
ପାଣିଭିତରୁ	/paːɳibʱit̪ɔru/
ପାଣିର	/paːɳiɾɔ/
ପାଣିରଖି	/paːɳiɾɔkʰi/
ପାଣିରେ	/paːɳire/
ପାତ	/paːt̪ɔ/
ପାତ୍ର	/paːt̪ɾɵ/
ପାତ୍ରକୁ	/paːt̪ɾɔku/
ପାତ୍ରର	/paːt̪ɾɔɾɔ/
ପାତ୍ରରୁ	/paːt̪ɾɔru/
ପାଦ	/paːd̪ɵ/
ପାଦରେ	/paːd̪ɔre/
ପାଦଶବ୍ଦ	/paːd̪ɔsɔbd̪ɔ/
ପାନ	/paːnɵ/
ପାନିଆଟିଏ	/paːniaːʈie/
ପାନିପଥ	/paːnipɔt̪ʰɔ/
ପାନୀୟ	/paːnijɵ/
ପାପ	/paːpɵ/
ପାର	/paːɾɔ/
ପାରନ୍ତି	/paːɾɔnt̪i/
ପାରମ୍ପରିକ	/paːɾɵmpɵrikɵ/
ପାରା	/paːraː/
ପାରାମାନେ	/paːraːmaːne/
ପାରି	/paːri/
ପାରିଥିଲେ	/paːrit̪ʰile/
ପାରିନି	/paːrini/
ପାରିବ	/paːribɵ/
ପାରିବନି	/paːribɔni/
ପାରିବା	/paːribaː/
ପାରିବାରେ	/paːribaːre/
ପାରିବି	/paːribi/
ପାରିବିକି	/paːribiki/
ପାରିବିନି	/paːribini/
ପାରିବୁ	/paːribu/
ପାରିବେ	/paːribe/
ପାରିବେନି	/paːribeni/
ପାରିଲା	/paːrilaː/
ପାରିଲେ	/paːrile/
ପାରିଲେନି	/paːrileni/
ପାରିହେଇଗଲା	/paːriheiɡɔlaː/
ପାରୁ	/paːru/
ପାରୁଛ	/paːrut͡ʃʰɔ/
ପାରୁଛନ୍ତି	/paːrut͡ʃʰɔnt̪i/
ପାରୁଛି	/paːrut͡ʃʰi/
ପାରୁଥିବା	/paːrut̪ʰibaː/
ପାରୁଥିଲେ	/paːrut̪ʰile/
ପାରୁନଥାନ୍ତି	/paːrunɔt̪ʰaːnt̪i/
ପାରୁନାଁହ	/paːrunaː̃hɔ/
ପାରୁନାହିଁ	/paːrunaːhĩ/
ପାରେ	/paːre/
ପାରେକି	/paːreki/
ପାର୍ଟି	/paːrʈi/
ପାର୍ବତୀ	/paːrbɵt̪i/
ପାର୍ଶି	/paːrsi/
ପାଲଟି	/paːlɔʈi/
ପାଲା	/paːlaː/
ପାଲିତ	/paːlit̪ɵ/
ପାଳନ	/paːl̪ɵnɵ/
ପାଳି	/paːl̪i/
ପାଳିଛି	/paːl̪it͡ʃʰi/
ପାଳିତ	/paːl̪it̪ɵ/
ପାଳିବାକୁ	/paːl̪ibaːku/
ପାଳିବୁ	/paːl̪ibu/
ପାଳୁଛି	/paːl̪ut͡ʃʰi/
ପାହାଚ	/paːhaːt͡ʃɔ/
ପାହାଞ୍ଚ	/paːhaːɲt͡ʃɔ/
ପାହାଡ଼	/paːhaːɖɵ/
ପାହାଡ଼	/paːhaːɽɔ/
ପାହାରେ	/paːhaːre/
ପି	/pi/
ପିଁ	/pĩ/
ପିଅ	/piɔ/
ପିଅନ୍ତି	/piɔnt̪i/
ପିଆଜ	/piaːd͡ʒɵ/
ପିଆଜି	/piaːd͡ʒi/
ପିଇ	/pii/
ପିଇବାକୁ	/piibaːku/
ପିଇବାରେ	/piibaːre/
ପିଇଲା	/piilaː/
ପିଟାରା	/piʈaːraː/
ପିଟି	/piʈi/
ପିଠା	/piʈʰaː/
ପିଠି	/piʈʰi/
ପିଠିରେ	/piʈʰire/
ପିଢ଼ି	/piɽʱi/
ପିତା	/pit̪aː/
ପିତାଙ୍କ	/pit̪aːŋkɵ/
ପିନ୍ଧନ୍ତି	/pind̪ʱɔnt̪i/
ପିନ୍ଧନ୍ତେ	/pind̪ʱɔnt̪e/
ପିନ୍ଧା	/pind̪ʱaː/
ପିନ୍ଧାଇବାକୁ	/pind̪ʱaːibaːku/
ପିନ୍ଧି	/pind̪ʱi/
ପିନ୍ଧିଛନ୍ତି	/pind̪ʱit͡ʃʰɔnt̪i/
ପିନ୍ଧିଛି	/pind̪ʱit͡ʃʰi/
ପିନ୍ଧିଥିବା	/pind̪ʱit̪ʰibaː/
ପିନ୍ଧିଥିଲା	/pind̪ʱit̪ʰilaː/
ପିନ୍ଧିବା	/pind̪ʱibaː/
ପିନ୍ଧିବାକୁ	/pind̪ʱibaːku/
ପିନ୍ଧିବାରେ	/pind̪ʱibaːre/
ପିନ୍ଧିବି	/pind̪ʱibi/
ପିନ୍ଧିଲା	/pind̪ʱilaː/
ପିନ୍ଧିଲୁ	/pind̪ʱilu/
ପିନ୍ଧିଲେ	/pind̪ʱile/
ପିନ୍ଧୁଥିବା	/pind̪ʱut̪ʰibaː/
ପିମ୍ପୁଡ଼ି	/pimpuɽi/
ପିମ୍ପୁଡ଼ିମାନେ	/pimpuɽimaːne/
ପିୟାଜ	/pijaːd͡ʒɔ/
ପିୟାଜକୁ	/pijaːd͡ʒɔku/
ପିରାମିଡ	/piraːmiɖɔ/
ପିଲଟି	/pilɔʈi/
ପିଲା	/pilaː/
ପିଲାଏ	/pilaːe/
ପିଲାକୁ	/pilaːku/
ପିଲାଗୁଡ଼ିକ	/pilaːguɽikɔ/
ପିଲାଙ୍କ	/pilaːŋkɔ/
ପିଲାଙ୍କୁ	/pilaːŋku/
ପିଲାଟି	/pilaːʈi/
ପିଲାଟିଏ	/pilaːʈie/
ପିଲାଟିକୁ	/pilaːʈiku/
ପିଲାଟିର	/pilaːʈiɾɔ/
ପିଲାମାନଂକୁ	/pilaːmaːnɔŋku/
ପିଲାମାନଙ୍କ	/pilaːmaːnɔŋkɔ/
ପିଲାମାନଙ୍କର	/pilaːmaːnɔŋkɔɾɔ/
ପିଲାମାନଙ୍କୁ	/pilaːmaːnɔŋku/
ପିଲାମାନେ	/pilaːmaːne/
ପିଲାସହ	/pilaːsɔhɔ/
ପୀଠ	/piʈʰɵ/
ପୁଅ	/puɵ/
ପୁଅକୁ	/puɔku/
ପୁଅଟିର	/puɔʈiɾɔ/
ପୁଜା	/pud͡ʒaː/
ପୁଡିଆ	/puɖiaː/
ପୁଣି	/puɳi/
ପୁଣିଥରେ	/puɳit̪ʰɔre/
ପୁତ୍ର	/put̪ɾɵ/
ପୁଦିନା	/pud̪inaː/
ପୁନପ୍ରେରଣ	/punɵpreɾɵɳɵ/
ପୁପୁ	/pupu/
ପୁରସ୍କାର	/puɾɵskaːɾɵ/
ପୁରା	/puraː/
ପୁରାଇ	/puraːi/
ପୁରାଇବା	/puraːibaː/
ପୁରାଣ	/puraːɳɵ/
ପୁରାତନ	/puraːt̪ɵnɵ/
ପୁରାପୁରି	/puraːpuri/
ପୁରାଯାଉଛି	/puraːd͡ʒaːut͡ʃʰi/
ପୁରାଯିବ	/puraːd͡ʒibɔ/
ପୁରି	/puri/
ପୁରିଥିବା	/purit̪ʰibaː/
ପୁରୀ	/puri/
ପୁରୁଖା	/purukʰaː/
ପୁରୁଣା	/puruɳaː/
ପୁରୁଣାପତ୍ରିକା	/puruɳaːpɔt̪rikaː/
ପୁରୁଷ	/purusɵ/
ପୁରୁଷୋତ୍ତମ	/purusot̪t̪ɵmɵ/
ପୁଳେ	/pul̪e/
ପୁଷ୍ପ	/puspɵ/
ପୁସ୍ତକ	/pust̪ɵkɵ/
ପୁସ୍ତିକା	/pust̪ikaː/
ପୂ	/pu/
ପୂକାଲାମ୍	/pukaːlaːm/
ପୂଜା	/pud͡ʒaː/
ପୂଜାରୀ	/pud͡ʒaːri/
ପୂଜାର୍ଚ୍ଚନା	/pud͡ʒaːrt͡ʃt͡ʃɵnaː/
ପୂରା	/puraː/
ପୂରେଇବ	/pureibɔ/
ପୂର୍ଣ୍ଣ	/purɳɳɵ/
ପୂର୍ଣ୍ଣଚନ୍ଦ୍ର	/purɳɳɵt͡ʃɵnd̪ɾɵ/
ପୂର୍ଣ୍ଣଛେଦ	/purɳɳɔt͡ʃʰed̪ɔ/
ପୂର୍ଣ୍ଣିମା	/purɳɳimaː/
ପୂର୍ତ୍ତି	/purt̪t̪i/
ପୂର୍ବ	/purbɵ/
ପୂର୍ବକ	/purbɵkɵ/
ପୂର୍ବତନ	/purbɵt̪ɵnɵ/
ପୂର୍ବରୁ	/purbɵru/
ପୂର୍ବେ	/purbe/
ପୃ	/pru/
ପୃଥକ୍	/prut̪ʰɔk/
ପୃଥିବୀ	/prut̪ʰibi/
ପୃଥିବୀର	/prut̪ʰibiɾɵ/
ପୃଥିବୀରେ	/prut̪ʰibire/
ପୃଷ୍ଟିସାର	/prusʈisaːɾɔ/
ପୃଷ୍ଠା	/prusʈʰaː/
ପୃଷ୍ଠାଗୁଡ଼ିକ	/prusʈʰaːguɽikɔ/
ପୃଷ୍ଠାଟି	/prusʈʰaːʈi/
ପୃଷ୍ଠାଟିଏ	/prusʈʰaːʈie/
ପୃଷ୍ଠାର	/prusʈʰaːɾɵ/
ପୃଷ୍ଠାରେ	/prusʈʰaːre/
ପେଚାର	/pet͡ʃaːɾɔ/
ପେଟ	/peʈɵ/
ପେଟକୁ	/peʈɔku/
ପେଟର	/peʈɔɾɔ/
ପେଟରୁ	/peʈɔru/
ପେଟରେ	/peʈɔre/
ପେଟେ	/peʈe/
ପେଡ଼ି	/peɽi/
ପେଣ୍ଡୁରେ	/peɳɖure/
ପେନ୍ସିଲ୍	/pensil/
ପେପେ	/pepe/
ପେପେକୁ	/pepeku/
ପେଷ୍ଟ୍	/pesʈ/
ପୋକ	/pokɔ/
ପୋକ-ଜୋକ	/pokɔ-d͡ʒokɔ/
ପୋକକୁ	/pokɔku/
ପୋକର	/pokɔɾɔ/
ପୋଖରୀ	/pokʰɔri/
ପୋଖରୀଟି	/pokʰɔriʈi/
ପୋଂଗଲ୍	/poŋɡɔl/
ପୋଙ୍ଖ	/poŋkʰɔ/
ପୋଡନ୍ତି	/poɖɔnt̪i/
ପୋତିଲୁ	/pot̪ilu/
ପୋଦିନା	/pod̪inaː/
ପୋର୍ଟାଲ	/porʈaːlɵ/
ପୋଲ	/polɔ/
ପୋଷକ	/posɵkɵ/
ପୋଷାକ	/posaːkɔ/
ପୋଷାକକୁ	/posaːkɔku/
ପୋଷାକଟି	/posaːkɔʈi/
ପୋଷାକଟିକୁ	/posaːkɔʈiku/
ପୋଷାକର	/posaːkɔɾɔ/
ପୋଷାକରେ	/posaːkɔre/
ପୋଷ୍ଟମ୍ୟାନ୍	/posʈɔmjaːn/
ପୋଷ୍ଟାଲ	/posʈaːlɵ/
ପୌ	/pou/
ପୌର	/pouɾɵ/
ପୌରାଣିକ	/pouraːɳikɵ/
ପୌଷ	/pousɵ/
ପ୍ୟାକେଟ୍	/pjaːkeʈ/
ପ୍ୟାରିସ୍	/pjaːris/
ପ୍ରକଳ୍ପ	/pɾɵkɵl̪pɵ/
ପ୍ରକାର	/pɾɵkaːɾɵ/
ପ୍ରକାରର	/pɾɵkaːɾɵɾɵ/
ପ୍ରକାଶ	/pɾɵkaːsɵ/
ପ୍ରକାଶନ	/pɾɵkaːsɵnɵ/
ପ୍ରକାଶିତ	/pɾɵkaːsit̪ɵ/
ପ୍ରକୃତ	/pɾɵkrut̪ɵ/
ପ୍ରକୃତରେ	/pɾɔkrut̪ɔre/
ପ୍ରକୃତି	/pɾɵkrut̪i/
ପ୍ରକ୍ରିୟା	/pɾɵkrijaː/
ପ୍ରଚଳନ	/pɾɵt͡ʃɵl̪ɵnɵ/
ପ୍ରଚଳିତ	/pɾɵt͡ʃɵl̪it̪ɵ/
ପ୍ରଚାର	/pɾɵt͡ʃaːɾɵ/
ପ୍ରଚୁର	/pɾɔt͡ʃuɾɔ/
ପ୍ରଚ୍ଛଦପଟ	/pɾɵt͡ʃt͡ʃʰɵd̪ɵpɵʈɵ/
ପ୍ରଜାପତି	/pɾɔd͡ʒaːpɔt̪i/
ପ୍ରଜାପତିମାନଙ୍କୁ	/pɾɔd͡ʒaːpɔt̪imaːnɔŋku/
ପ୍ରଜାପତିମାନେ	/pɾɔd͡ʒaːpɔt̪imaːne/
ପ୍ରଣାମ	/pɾɔɳaːmɔ/
ପ୍ରଣାଳୀ	/pɾɵɳaːl̪i/
ପ୍ରତଯାତ	/pɾɔt̪ɔd͡ʒaːt̪ɔ/
ପ୍ରତାପ	/pɾɵt̪aːpɵ/
ପ୍ରତି	/pɾɵt̪i/
ପ୍ରତିକୃତି	/pɾɔt̪ikrut̪i/
ପ୍ରତିକ୍ରିୟା	/pɾɔt̪ikrijaː/
ପ୍ରତିଥର	/pɾɔt̪it̪ʰɔɾɔ/
ପ୍ରତିଦିନ	/pɾɵt̪id̪inɵ/
ପ୍ରତିପତ୍ତି	/pɾɔt̪ipɔt̪t̪i/
ପ୍ରତିବର୍ଷ	/pɾɵt̪ibɵrsɵ/
ପ୍ରତିଭା	/pɾɵt̪ibʱaː/
ପ୍ରତିମା	/pɾɵt̪imaː/
ପ୍ରତିଯୋଗିତା	/pɾɔt̪id͡ʒogit̪aː/
ପ୍ରତିରୋଧ	/pɾɵt̪irod̪ʱɵ/
ପ୍ରତିଶତ	/pɾɔt̪isɔt̪ɔ/
ପ୍ରତିଷ୍ଠା	/pɾɵt̪isʈʰaː/
ପ୍ରତିଷ୍ଠାତା	/pɾɵt̪isʈʰaːt̪aː/
ପ୍ରତିଷ୍ଠିତ	/pɾɵt̪isʈʰit̪ɵ/
ପ୍ରତୀକ	/pɾɵt̪ikɵ/
ପ୍ରତ୍ୟେକ	/pɾɵt̪jekɵ/
ପ୍ରତ୍ୟେକେ	/pɾɔt̪jeke/
ପ୍ରଥମ	/pɾɵt̪ʰɵmɵ/
ପ୍ରଥମେ	/pɾɵt̪ʰɵme/
ପ୍ରଥା	/pɾɵt̪ʰaː/
ପ୍ରଦର୍ଶନ	/pɾɵd̪ɵrsɵnɵ/
ପ୍ରଦର୍ଶିତ	/pɾɔd̪ɔrsit̪ɔ/
ପ୍ରଦାନ	/pɾɵd̪aːnɵ/
ପ୍ରଦାହ	/pɾɵd̪aːhɵ/
ପ୍ରଦେଶ	/pɾɵd̪esɵ/
ପ୍ରଦେଶର	/pɾɵd̪esɵɾɵ/
ପ୍ରଧାନ	/pɾɵd̪ʱaːnɵ/
ପ୍ରଧାନମନ୍ତ୍ରୀ	/pɾɵd̪ʱaːnɵmɵnt̪ri/
ପ୍ରଫୁଲ୍ଲ	/pɾɵpʰullɵ/
ପ୍ରଫୁଲ୍ଲିତ	/pɾɔpʰullit̪ɔ/
ପ୍ରଫେସର	/pɾɵpʰesɵɾɵ/
ପ୍ରବନ୍ଧ	/pɾɵbɵnd̪ʱɵ/
ପ୍ରବଳ	/pɾɵbɵl̪ɵ/
ପ୍ରବାହିତ	/pɾɔbaːhit̪ɔ/
ପ୍ରବୀଣ	/pɾɔbiɳɔ/
ପ୍ରବେଶ	/pɾɵbesɵ/
ପ୍ରଭାବ	/pɾɵbʱaːbɵ/
ପ୍ରଭାବିତ	/pɾɵbʱaːbit̪ɵ/
ପ୍ରଭୁ	/pɾɵbʱu/
ପ୍ରଭୃତି	/pɾɵbʱrut̪i/
ପ୍ରମାଣ	/pɾɵmaːɳɵ/
ପ୍ରମୁଖ	/pɾɵmukʰɵ/
ପ୍ରଯୁକ୍ତି	/pɾɵd͡ʒukt̪i/
ପ୍ରଯୋଜକ	/pɾɵd͡ʒod͡ʒɵkɵ/
ପ୍ରୟୋଗ	/pɾɵjoɡɵ/
ପ୍ରଶଂସା	/pɾɔsɔŋsaː/
ପ୍ରଶାନ୍ତ	/pɾɵsaːnt̪ɵ/
ପ୍ରଶାସନିକ	/pɾɵsaːsɵnikɵ/
ପ୍ରଶ୍ନ	/pɾɵsnɵ/
ପ୍ରଶ୍ନର	/pɾɔsnɔɾɔ/
ପ୍ରସଙ୍ଗ	/pɾɵsɵŋɡɵ/
ପ୍ରସଙ୍ଗଟି	/pɾɵsɵŋɡɵʈi/
ପ୍ରସଙ୍ଗର	/pɾɵsɵŋɡɵɾɵ/
ପ୍ରସଙ୍ଗରେ	/pɾɵsɵŋɡɵre/
ପ୍ରସନ୍ନ	/pɾɵsɵnnɵ/
ପ୍ରସାଦ	/pɾɵsaːd̪ɵ/
ପ୍ରସାଧନ	/pɾɵsaːd̪ʱɵnɵ/
ପ୍ରସାର	/pɾɵsaːɾɵ/
ପ୍ରସିଦ୍ଧ	/pɾɵsid̪d̪ʱɵ/
ପ୍ରସ୍ତାବ	/pɾɵst̪aːbɵ/
ପ୍ରସ୍ତୁତ	/pɾɵst̪ut̪ɵ/
ପ୍ରସ୍ତୁତି	/pɾɵst̪ut̪i/
ପ୍ରସ୍ତୁତିରେ	/pɾɔst̪ut̪ire/
ପ୍ରହରାଜ	/pɾɵhɵraːd͡ʒɵ/
ପ୍ରହରୀଟି	/pɾɔhɔriʈi/
ପ୍ରାକୃତିକ	/praːkrut̪ikɵ/
ପ୍ରାଚୀନ	/praːt͡ʃinɵ/
ପ୍ରାଣ	/praːɳɵ/
ପ୍ରାଣୀ	/praːɳi/
ପ୍ରାଣେ	/praːɳe/
ପ୍ରାଥମିକ	/praːt̪ʰɵmikɵ/
ପ୍ରାଦେଶିକ	/praːd̪esikɵ/
ପ୍ରାନ୍ତରୁ	/praːnt̪ɵru/
ପ୍ରାପ୍ତ	/praːpt̪ɵ/
ପ୍ରାୟ	/praːjɵ/
ପ୍ରାରମ୍ଭିକ	/praːɾɵmbʱikɵ/
ପ୍ରାର୍ଥନା	/praːrt̪ʰɵnaː/
ପ୍ରାର୍ଥୀ	/praːrt̪ʰi/
ପ୍ରିତିକ୍ରିୟା	/prit̪ikrijaː/
ପ୍ରିୟ	/prijɵ/
ପ୍ରେମ	/premɵ/
ପ୍ରେସ	/presɵ/
ପ୍ରୋଗ୍ରାମିଂ	/prograːmiŋ/
ପ୍ଲାଷ୍ଟିକ୍	/plaːsʈik/
ପ୍ଲାସ୍ଟିକ୍	/plaːsʈik/
ଫକୀର	/pʰɵkiɾɵ/
ଫଟକ	/pʰɔʈɔkɔ/
ଫଟା	/pʰɔʈaː/
ଫଟାଇ	/pʰɔʈaːi/
ଫଟେଇ	/pʰɔʈei/
ଫଟୋ	/pʰɵʈo/
ଫତେପୁର	/pʰɔt̪epuɾɔ/
ଫନି	/pʰɔni/
ଫନିକୁ	/pʰɔniku/
ଫନିର	/pʰɔniɾɔ/
ଫରହାନ	/pʰɔɾɔhaːnɔ/
ଫଳ	/pʰɵl̪ɵ/
ଫଳଟି	/pʰɔl̪ɔʈi/
ଫଳମାନେ	/pʰɔl̪ɔmaːne/
ଫଳରେ	/pʰɵl̪ɵre/
ଫଳାଫଳ	/pʰɵl̪aːpʰɵl̪ɵ/
ଫଳିଆ	/pʰɔl̪iaː/
ଫଳିଥିବା	/pʰɔl̪it̪ʰibaː/
ଫସଲ	/pʰɔsɔlɔ/
ଫହୁ	/pʰɔhu/
ଫାଇଲ	/pʰaːilɵ/
ଫାଉଣ୍ଡେସନ	/pʰaːuɳɖesɵnɵ/
ଫାଟକ	/pʰaːʈɔkɔ/
ଫାଟି	/pʰaːʈi/
ଫାର୍	/pʰaːr/
ଫାଲୁଦା	/pʰaːlud̪aː/
ଫାଳିଆ	/pʰaːl̪iaː/
ଫାଳିଆକୁ	/pʰaːl̪iaːku/
ଫାଳିଆରେ	/pʰaːl̪iaːre/
ଫିକା	/pʰikaː/
ଫିଙ୍ଗନ୍ତି	/pʰiŋɡɔnt̪i/
ଫିଙ୍ଗି	/pʰiŋgi/
ଫିଙ୍ଗିବି	/pʰiŋgibi/
ଫିଟାଇ	/pʰiʈaːi/
ଫିଲ୍ମ	/pʰilmɵ/
ଫିସ୍	/pʰis/
ଫୁଉସ୍	/pʰuus/
ଫୁଂକାରେ	/pʰuŋkaːre/
ଫୁଂକିବା	/pʰuŋkibaː/
ଫୁଂକିବାକୁ	/pʰuŋkibaːku/
ଫୁଙ୍କୁଥିଲେ	/pʰuŋkut̪ʰile/
ଫୁଟ	/pʰuʈɵ/
ଫୁଟନ୍ତା	/pʰuʈɔnt̪aː/
ଫୁଟା	/pʰuʈaː/
ଫୁଟିଛି	/pʰuʈit͡ʃʰi/
ଫୁଟିଥିଲା	/pʰuʈit̪ʰilaː/
ଫୁଟୁଥିବା	/pʰuʈut̪ʰibaː/
ଫୁଟେଇବା	/pʰuʈeibaː/
ଫୁର୍-ଫୁର୍	/pʰur-pʰur/
ଫୁଲ	/pʰulɵ/
ଫୁଲକୁ	/pʰulɔku/
ଫୁଲଗୁଚ୍ଛାଟିଏ	/pʰulɔgut͡ʃt͡ʃʰaːʈie/
ଫୁଲଗୁଡ଼ିକ	/pʰulɔguɽikɔ/
ଫୁଲଟିଏ	/pʰulɔʈie/
ଫୁଲଭର୍ତ୍ତି	/pʰulɔbʰɔrt̪t̪i/
ଫୁଲମାନେ	/pʰulɔmaːne/
ଫୁଲର	/pʰulɔɾɔ/
ଫୁଲରୁ	/pʰulɔru/
ଫୁଲରେ	/pʰulɔre/
ଫୁସଫୁସ	/pʰusɵpʰusɵ/
ଫୁସୁଲାନ୍ତି	/pʰusulaːnt̪i/
ଫେଡ଼େ	/pʰeɽe/
ଫେଣରେ	/pʰeɳɔre/
ଫେଣା	/pʰeɳaː/
ଫେବୃଆରିର	/pʰebruaːriɾɔ/
ଫେବୃଆରୀ	/pʰebruaːri/
ଫେରାଇ	/pʰeraːi/
ଫେରି	/pʰeri/
ଫେରିଆସିଲା	/pʰeriaːsilaː/
ଫେରିଆସିଲେ	/pʰeriaːsile/
ଫେରିଛି	/pʰerit͡ʃʰi/
ଫେରିବା	/pʰeribaː/
ଫେରିବାକୁ	/pʰeribaːku/
ଫେରିଲା	/pʰerilaː/
ଫେରିଲେନି	/pʰerileni/
ଫେରୁଛି	/pʰerut͡ʃʰi/
ଫେରୁଥାନ୍ତି	/pʰerut̪ʰaːnt̪i/
ଫେରେଇନେଲା	/pʰereinelaː/
ଫେସବୁକ	/pʰesɵbukɵ/
ଫୋନ୍	/pʰon/
ଫୋପାଡ଼ି	/pʰopaːɽi/
ଫୋପାଡ଼େ	/pʰopaːɽe/
ଫ୍ୟୁଜ୍	/pʰjud͡ʒ/
ଫ୍ରକ୍	/pʰɾɔk/
ଫ୍ରିଜ୍	/pʰrid͡ʒ/
ବକ୍‌ବକ୍‌	/bɔkbɔk/
ବକ୍ସ	/bɔksɔ/
ବଗିଚା	/bɔgit͡ʃaː/
ବଗିଚାକୁ	/bɔgit͡ʃaːku/
ବଗିଚାରୁ	/bɔgit͡ʃaːru/
ବଗିଚାରେ	/bɔgit͡ʃaːre/
ବଗୀଚା	/bɔgit͡ʃaː/
ବଙ୍କାକରି	/bɔŋkaːkɔri/
ବଙ୍ଗ	/bɵŋɡɵ/
ବଙ୍ଗଳା	/bɵŋɡɵl̪aː/
ବଛା	/bɵt͡ʃʰaː/
ବଜାଇ	/bɔd͡ʒaːi/
ବଜାଇବା	/bɔd͡ʒaːibaː/
ବଜାଇବାକୁ	/bɔd͡ʒaːibaːku/
ବଜାଉଛନ୍ତି	/bɔd͡ʒaːut͡ʃʰɔnt̪i/
ବଜାୟ	/bɔd͡ʒaːjɔ/
ବଜାର	/bɵd͡ʒaːɾɵ/
ବଜାରକୁ	/bɔd͡ʒaːɾɔku/
ବଜାରରୁ	/bɔd͡ʒaːɾɔru/
ବଜାର୍	/bɔd͡ʒaːr/
ବଜେଇବାକୁ	/bɔd͡ʒeibaːku/
ବଞ୍ଚନ୍ତି	/bɔɲt͡ʃɔnt̪i/
ବଞ୍ଚାଅ	/bɔɲt͡ʃaːɔ/
ବଞ୍ଚିପାରନ୍ତି	/bɔɲt͡ʃipaːɾɔnt̪i/
ବଞ୍ଚିବା	/bɔɲt͡ʃibaː/
ବଞ୍ଚୁଥିବା	/bɔɲt͡ʃut̪ʰibaː/
ବଞ୍ଚେଇବା	/bɔɲt͡ʃeibaː/
ବଟ	/bɵʈɵ/
ବଟା	/bɔʈaː/
ବଟ୍	/bɵʈ/
ବଡ଼	/bɔɽɔ/
ବଡ	/bɵɖɵ/
ବଡ଼	/bɵɖɵ/
ବଡ଼-ବଡ଼	/bɔɽɔ-bɔɽɔ/
ବଡ଼-ମୁଣ୍ଡିଆ	/bɔɽɔ-muɳɖiaː/
ବଡ଼ପାଟିରେ	/bɔɽɔpaːʈire/
ବଡ଼ମାଛ	/bɔɽɔmaːt͡ʃʰɔ/
ବଡ଼ରୁ	/bɔɽɔru/
ବଡ଼ି	/bɔɽi/
ବଢାଉ	/bɔɖʱaːu/
ବଢ଼ି	/bɔɽʱi/
ବଢିଆ	/bɔɖʱiaː/
ବଢ଼ିଆ	/bɔɽʱiaː/
ବଢ଼ିବ	/bɔɽʱibɔ/
ବଢ଼ିଯାଇଛି	/bɔɽʱid͡ʒaːit͡ʃʰi/
ବଢ଼ିଲାଣି	/bɔɽʱilaːɳi/
ବଢ଼େଇ	/bɔɽʱei/
ବଣ	/bɔɳɔ/
ବଣ୍ଟା	/bɔɳʈaː/
ବତଉଚି	/bɔt̪ɔut͡ʃi/
ବତାଶ	/bɔt̪aːsɔ/
ବଦନ୍	/bɔd̪ɔn/
ବଦମାଶ୍	/bɔd̪ɔmaːs/
ବଦଳ	/bɵd̪ɵl̪ɵ/
ବଦଳକୁ	/bɵd̪ɵl̪ɵku/
ବଦଳରେ	/bɵd̪ɵl̪ɵre/
ବଦଳାଇବା	/bɔd̪ɔl̪aːibaː/
ବଦଳି	/bɔd̪ɔl̪i/
ବଦଳୁ	/bɔd̪ɔl̪u/
ବଦଳେଇବା	/bɵd̪ɵl̪eibaː/
ବଦଳେରେ	/bɔd̪ɔl̪ere/
ବଧ	/bɵd̪ʱɵ/
ବନାଇଲେ	/bɔnaːile/
ବନାଏ	/bɔnaːe/
ବନାନ	/bɵnaːnɵ/
ବନାନ୍ତି	/bɔnaːnt̪i/
ବନେଇ	/bɔnei/
ବନେଇଛନ୍ତି	/bɔneit͡ʃʰɔnt̪i/
ବନେଇଥାନ୍ତି	/bɔneit̪ʰaːnt̪i/
ବନେଇବା	/bɔneibaː/
ବନେଇବେ	/bɔneibe/
ବନେଇଲେ	/bɔneile/
ବନ୍ଦ	/bɵnd̪ɵ/
ବନ୍ଦକରି	/bɔnd̪ɔkɔri/
ବନ୍ଦର	/bɵnd̪ɵɾɵ/
ବନ୍ଧ	/bɵnd̪ʱɵ/
ବନ୍ଧନ	/bɵnd̪ʱɵnɵ/
ବନ୍ଧା	/bɔnd̪ʱaː/
ବନ୍ଧାକୋବି	/bɔnd̪ʱaːkobi/
ବନ୍ଧୁ	/bɵnd̪ʱu/
ବନ୍ଧୁକଧରି	/bɔnd̪ʱukɔd̪ʱɔri/
ବନ୍ଧୁଙ୍କୁ	/bɔnd̪ʱuŋku/
ବନ୍ଧୁମାନେ	/bɔnd̪ʱumaːne/
ବନ୍ୟଜନ୍ତୁ	/bɔnjɔd͡ʒɔnt̪u/
ବବୁଲ୍	/bɔbul/
ବୟସ	/bɵjɵsɵ/
ବୟସର	/bɔjɔsɔɾɔ/
ବୟସରେ	/bɵjɵsɵre/
ବୟସ୍କ	/bɔjɔskɔ/
ବରଂ	/bɔɾɔŋ/
ବର	/bɵɾɵ/
ବରକୁ	/bɔɾɔku/
ବରଗଡ଼	/bɵɾɵɡɵɖɵ/
ବରଫ	/bɔɾɔpʰɔ/
ବରଯାତ୍ରୀ	/bɔɾɔd͡ʒaːt̪ri/
ବରର	/bɔɾɔɾɔ/
ବରଷା	/bɔɾɔsaː/
ବରଷିବାକୁ	/bɔɾɔsibaːku/
ବରଷିଯାଆ	/bɔɾɔsid͡ʒaːaː/
ବରଷିଲା	/bɔɾɔsilaː/
ବରା	/bɔraː/
ବରାଦ	/bɔraːd̪ɔ/
ବରୁଣ	/bɔruɳɔ/
ବର୍ଗ	/bɵrɡɵ/
ବର୍ଚ୍ଛାଧରି	/bɔrt͡ʃt͡ʃʰaːd̪ʱɔri/
ବର୍ଣ୍ଣ	/bɵrɳɳɵ/
ବର୍ଣ୍ଣନା	/bɵrɳɳɵnaː/
ବର୍ଣ୍ଣନାକାରୀ	/bɔrɳɳɔnaːkaːri/
ବର୍ଣ୍ଣିତ	/bɵrɳɳit̪ɵ/
ବର୍ତ୍ତମାନ	/bɵrt̪t̪ɵmaːnɵ/
ବର୍ଫି	/bɔrpʰi/
ବର୍ଷ	/bɵrsɵ/
ବର୍ଷର	/bɵrsɵɾɵ/
ବର୍ଷରୁ	/bɵrsɵru/
ବର୍ଷରେ	/bɵrsɵre/
ବର୍ଷା	/bɵrsaː/
ବର୍ଷୁଥିବା	/bɔrsut̪ʰibaː/
ବର୍ଷେ	/bɔrse/
ବଲବ୍	/bɔlɔb/
ବଲାଙ୍ଗୀର	/bɵlaːŋgiɾɵ/
ବଲ୍	/bɔl/
ବଲ୍ଲଭ	/bɵllɵbʰɵ/
ବଳ	/bɵl̪ɵ/
ବଳକାରକ	/bɔl̪ɔkaːɾɔkɔ/
ବଳବାନ	/bɔl̪ɔbaːnɔ/
ବଳଭଦ୍ର	/bɵl̪ɵbʰɵd̪ɾɵ/
ବଳରାମ	/bɵl̪ɵraːmɵ/
ବଳୁଆ	/bɔl̪uaː/
ବଂଶ	/bɵŋsɵ/
ବଂଶର	/bɵŋsɵɾɵ/
ବଂଶାନୁଗତ	/bɔŋsaːnuɡɔt̪ɔ/
ବଂଶୀ	/bɔŋsi/
ବସ	/bɔsɔ/
ବସନ୍ତ	/bɵsɵnt̪ɵ/
ବସନ୍ତରେ	/bɔsɔnt̪ɔre/
ବସନ୍ତି	/bɔsɔnt̪i/
ବସାଇ	/bɔsaːi/
ବସାଇଲେ	/bɔsaːile/
ବସି	/bɵsi/
ବସିଗଲେ	/bɔsiɡɔle/
ବସିଛନ୍ତି	/bɔsit͡ʃʰɔnt̪i/
ବସିଥାଏ	/bɔsit̪ʰaːe/
ବସିଥାନ୍ତି	/bɔsit̪ʰaːnt̪i/
ବସିଥିବା	/bɔsit̪ʰibaː/
ବସିପଡ଼ି	/bɔsipɔɽi/
ବସିପଡିଲା	/bɔsipɔɖilaː/
ବସିପଡ଼ିଲା	/bɔsipɔɽilaː/
ବସିବା	/bɵsibaː/
ବସିବାକୁ	/bɔsibaːku/
ବସିବାପାଇଁ	/bɔsibaːpaːĩ/
ବସିଲା	/bɔsilaː/
ବସିଲି	/bɔsili/
ବସିଲେ	/bɔsile/
ବସୁଥିଲେ	/bɔsut̪ʰile/
ବସେ	/bɔse/
ବସେଇ	/bɔsei/
ବସ୍	/bɔs/
ବସ୍ତା	/bɔst̪aː/
ବସ୍ତାନି	/bɔst̪aːni/
ବସ୍ତାନୀ	/bɔst̪aːni/
ବସ୍ତୁ	/bɵst̪u/
ବସ୍ତ୍ର	/bɵst̪ɾɵ/
ବହନ	/bɵhɵnɵ/
ବହଲିଆ	/bɔhɔliaː/
ବହି	/bɵhi/
ବହିଗୁଡ଼ାକ	/bɔhiguɽaːkɔ/
ବହିଗୁଡ଼ିକ	/bɔhiguɽikɔ/
ବହିଟା	/bɔhiʈaː/
ବହିଟେ	/bɔhiʈe/
ବହିଥିଲା	/bɔhit̪ʰilaː/
ବହିର	/bɔhiɾɔ/
ବହିରୁ	/bɔhiru/
ବହିଲା	/bɔhilaː/
ବହୁ	/bɵhu/
ବହୁଜନ	/bɵhud͡ʒɵnɵ/
ବହୁତ	/bɵhut̪ɵ/
ବହୁଥର	/bɔhut̪ʰɔɾɔ/
ବହୁବିକଳ୍ପ	/bɵhubikɵl̪pɵ/
ବହୁମୂଲ୍ୟ	/bɔhumuljɔ/
ବହୁଳ	/bɵhul̪ɵ/
ବହେ	/bɔhe/
ବା	/baː/
ବାଁ	/baː̃/
ବାଃ	/baːh/
ବାଇଗଣ	/baːiɡɵɳɵ/
ବାଇଗଣୀ	/baːiɡɔɳi/
ବାଉଳା	/baːul̪aː/
ବାଉଁଶରେ	/baːũsɔre/
ବାକି	/baːki/
ବାକିଥିଲା	/baːkit̪ʰilaː/
ବାକୁ	/baːku/
ବାକ୍ୟ	/baːkjɔ/
ବାକ୍ସ	/baːksɔ/
ବାକ୍ସଟିକୁ	/baːksɔʈiku/
ବାକ୍ସରୁ	/baːksɔru/
ବାକ୍ସରେ	/baːksɔre/
ବାଗେଇ	/baːgei/
ବାଘ	/baːɡʱɵ/
ବାଘଟି	/baːɡʱɔʈi/
ବାଛି	/baːt͡ʃʰi/
ବାଛିବେ	/baːt͡ʃʰibe/
ବାଛୁଥିଲେ	/baːt͡ʃʰut̪ʰile/
ବାଜରା	/baːd͡ʒɔraː/
ବାଜା	/baːd͡ʒaː/
ବାଜାଟି	/baːd͡ʒaːʈi/
ବାଜାଟିକୁ	/baːd͡ʒaːʈiku/
ବାଜାବାଲା	/baːd͡ʒaːbaːlaː/
ବାଜାବାଲାଙ୍କୁ	/baːd͡ʒaːbaːlaːŋku/
ବାଜି	/baːd͡ʒi/
ବାଜିବା	/baːd͡ʒibaː/
ବାଜିଲା	/baːd͡ʒilaː/
ବାଜିଲାଣି	/baːd͡ʒilaːɳi/
ବାଜୁଥାଏ	/baːd͡ʒut̪ʰaːe/
ବାଟ	/baːʈɵ/
ବାଟଦେଇ	/baːʈɔd̪ei/
ବାଟରେ	/baːʈɔre/
ବାଟି	/baːʈi/
ବାଟୁଳି	/baːʈul̪i/
ବାଟେ	/baːʈe/
ବାଟୋଇମାନଙ୍କୁ	/baːʈoimaːnɔŋku/
ବାଡ଼ାନି	/baːɽaːni/
ବାଡ଼ି	/baːɽi/
ବାଡ଼ିରେ	/baːɽire/
ବାଡ଼େଇଲି	/baːɽeili/
ବାଢିଦେବୁ	/baːɖʱid̪ebu/
ବାଣ	/baːɳɔ/
ବାଣୀ	/baːɳi/
ବାଣୀକୁ	/baːɳiku/
ବାଣୀର	/baːɳiɾɔ/
ବାଣ୍ଟିଲା	/baːɳʈilaː/
ବାତ	/baːt̪ɵ/
ବାଦଲ	/baːd̪ɔlɔ/
ବାଦଲଟିଏ	/baːd̪ɔlɔʈie/
ବାଦଲ୍‌	/baːd̪ɔl/
ବାଦାମ	/baːd̪aːmɔ/
ବାଦାମବାଲା	/baːd̪aːmɔbaːlaː/
ବାଦାମୀ	/baːd̪aːmi/
ବାନାର୍ଜୀ	/baːnaːrd͡ʒi/
ବାନ୍ତି	/baːnt̪i/
ବାନ୍ଧ	/baːnd̪ʱɔ/
ବାନ୍ଧଣୀ	/baːnd̪ʱɔɳi/
ବାନ୍ଧି	/baːnd̪ʱi/
ବାନ୍ଧିଥିଲା	/baːnd̪ʱit̪ʰilaː/
ବାନ୍ଧିଦେ	/baːnd̪ʱid̪e/
ବାନ୍ଧିଦେଲା	/baːnd̪ʱid̪elaː/
ବାନ୍ଧିବା	/baːnd̪ʱibaː/
ବାନ୍ଧିଲା	/baːnd̪ʱilaː/
ବାପା	/baːpaː/
ବାପା-ବିଲେଇ	/baːpaː-bilei/
ବାପା-ବିଲେଇର	/baːpaː-bileiɾɔ/
ବାପା-ମା	/baːpaː-maː/
ବାପାଂକୁ	/baːpaːŋku/
ବାପାଙ୍କ	/baːpaːŋkɔ/
ବାପାଙ୍କୁ	/baːpaːŋku/
ବାପାମାଆଙ୍କୁ	/baːpaːmaːaːŋku/
ବାପାର	/baːpaːɾɔ/
ବାବଦରେ	/baːbɵd̪ɵre/
ବାବର	/baːbɔɾɔ/
ବାବରଙ୍କ	/baːbɔɾɔŋkɔ/
ବାବା	/baːbaː/
ବାବୁ	/baːbu/
ବାମ	/baːmɵ/
ବାମନ	/baːmɵnɵ/
ବାୟ	/baːjɔ/
ବାୟୁ	/baːju/
ବାର	/baːɾɔ/
ବାରଣ୍ତାରେ	/baːɾɔɳt̪aːre/
ବାରବାଟି	/baːɾɵbaːʈi/
ବାରମାସୀ	/baːɾɔmaːsi/
ବାରମ୍ବାର	/baːɾɵmbaːɾɵ/
ବାରାଣସୀ	/baːraːɳɔsi/
ବାରିକ	/baːrikɔ/
ବାରିପଦା	/baːripɵd̪aː/
ବାରିବାକୁ	/baːribaːku/
ବାର୍ଥ୍	/baːrt̪ʰ/
ବାର୍ଷିକ	/baːrsikɵ/
ବାଲାଙ୍କ	/baːlaːŋkɔ/
ବାଲାଙ୍କୁ	/baːlaːŋku/
ବାଲି	/baːli/
ବାଲୁ	/baːlu/
ବାଲେଶ୍ଵର	/baːlesuɵɾɵ/
ବାଲେଶ୍ୱର	/baːlesuɵɾɵ/
ବାଳ	/baːl̪ɔ/
ବାଳକ	/baːl̪ɔkɔ/
ବାଳକଟା	/baːl̪ɔkɔʈaː/
ବାଳକଣ	/baːl̪ɔkɔɳɔ/
ବାଷା	/baːsaː/
ବାଷାକୁ	/baːsaːku/
ବାଷାରଆତ୍ମବିଶ୍ୱାସବଢ଼ିବାରେ	/baːsaːɾɔaːt̪mɔbisuaːsɔbɔɽʱibaːre/
ବାଷ୍ପ	/baːspɔ/
ବାସ	/baːsɵ/
ବାସନମଜା	/baːsɔnɔmɔd͡ʒaː/
ବାସନା	/baːsɔnaː/
ବାସନ୍ତୀ	/baːsɔnt̪i/
ବାସନ୍ଦ	/baːsɔnd̪ɔ/
ବାସୁଦେବ	/baːsud̪ebɵ/
ବାସୁମତି	/baːsumɔt̪i/
ବାସ୍	/baːs/
ବାସ୍ନା	/baːsnaː/
ବାହନ	/baːhɔnɔ/
ବାହାଘର	/baːhaːɡʱɔɾɔ/
ବାହାଘରକୁ	/baːhaːɡʱɔɾɔku/
ବାହାଘରୁ	/baːhaːɡʱɔru/
ବାହାଦୁର	/baːhaːd̪uɾɔ/
ବାହାଦୁରି	/baːhaːd̪uri/
ବାହାପିଆ	/baːhaːpiaː/
ବାହାର	/baːhaːɾɵ/
ବାହାରକରି	/baːhaːɾɔkɔri/
ବାହାରକୁ	/baːhaːɾɔku/
ବାହାରନ୍ତି	/baːhaːɾɔnt̪i/
ବାହାରନ୍ତେ	/baːhaːɾɔnt̪e/
ବାହାରି	/baːhaːri/
ବାହାରିଆସିବ	/baːhaːriaːsibɔ/
ବାହାରିଛୁ	/baːhaːrit͡ʃʰu/
ବାହାରିଥିଲା	/baːhaːrit̪ʰilaː/
ବାହାରିଯିବ	/baːhaːrid͡ʒibɔ/
ବାହାରିଲା	/baːhaːrilaː/
ବାହାରିଲେ	/baːhaːrile/
ବାହାରୁ	/baːhaːru/
ବାହାରେ	/baːhaːre/
ବାହ୍ୟ	/baːhjɵ/
ବି	/bi/
ବିକଳରେ	/bikɔl̪ɔre/
ବିକାଶ	/bikaːsɵ/
ବିକିକରି	/bikikɔri/
ବିକୁଥିଲେ	/bikut̪ʰile/
ବିକୃତ	/bikrut̪ɔ/
ବିକ୍ରିକରି	/bikrikɔri/
ବିଖ୍ୟାତ	/bikʰjaːt̪ɵ/
ବିଗଳିତ	/biɡɔl̪it̪ɔ/
ବିଗ୍ରହ	/bigɾɵhɵ/
ବିଚରା	/bit͡ʃɔraː/
ବିଚଳିତ	/bit͡ʃɔl̪it̪ɔ/
ବିଚାର	/bit͡ʃaːɾɵ/
ବିଚାରା	/bit͡ʃaːraː/
ବିଚିତ୍ର	/bit͡ʃit̪ɾɔ/
ବିଛଣା	/bit͡ʃʰɔɳaː/
ବିଛଣାରୁ	/bit͡ʃʰɔɳaːru/
ବିଛା	/bit͡ʃʰaː/
ବିଛେଇ	/bit͡ʃʰei/
ବିଜଦ	/bid͡ʒɵd̪ɵ/
ବିଜୟ	/bid͡ʒɵjɵ/
ବିଜୟୀ	/bid͡ʒɵji/
ବିଜୁ	/bid͡ʒu/
ବିଜୁଳି	/bid͡ʒul̪i/
ବିଜୁଳିର	/bid͡ʒul̪iɾɔ/
ବିଜେ	/bid͡ʒe/
ବିଜେତା	/bid͡ʒet̪aː/
ବିଜ୍ଞାନ	/bid͡ʒɲaːnɵ/
ବିଜ୍ଞାନୀ	/bid͡ʒɲaːni/
ବିଜ୍ଞାପିତ	/bid͡ʒɲaːpit̪ɵ/
ବିତି	/bit̪i/
ବିତିଗଲା	/bit̪iɡɔlaː/
ବିଦ୍ୟା	/bid̪jaː/
ବିଦ୍ୟାଳୟ	/bid̪jaːl̪ɵjɵ/
ବିଦ୍ୟୁତ	/bid̪jut̪ɵ/
ବିଦ୍ୟୁତ୍	/bid̪jut̪/
ବିଦ୍ର	/bid̪ɾɵ/
ବିଧାନ	/bid̪ʱaːnɵ/
ବିଧାନସଭା	/bid̪ʱaːnɵsɵbʱaː/
ବିଧାୟକ	/bid̪ʱaːjɵkɵ/
ବିଧାୟକଗଣ	/bid̪ʱaːjɵkɵɡɵɳɵ/
ବିଧି	/bid̪ʱi/
ବିଂଧୁଛି	/biŋd̪ʱut͡ʃʰi/
ବିନତି	/binɔt̪i/
ବିନତୀ	/binɔt̪i/
ବିନା	/binaː/
ବିନି	/bini/
ବିନିକୁ	/biniku/
ବିନିର	/biniɾɔ/
ବିନୋଦ	/binod̪ɵ/
ବିନ୍	/bin/
ବିନ୍ଦା	/bind̪aː/
ବିନ୍ଦୁ	/bind̪u/
ବିନ୍ୟାସ	/binjaːsɔ/
ବିବରଣୀ	/bibɵɾɵɳi/
ବିବାହ	/bibaːhɵ/
ବିବିଧ	/bibid̪ʱɵ/
ବିବେକାନନ୍ଦ	/bibekaːnɵnd̪ɵ/
ବିଭକ୍ତ	/bibʰɵkt̪ɵ/
ବିଭାଗ	/bibʱaːɡɵ/
ବିଭାଗର	/bibʱaːɡɵɾɵ/
ବିଭାଗରେ	/bibʱaːɡɵre/
ବିଭାଜନ	/bibʱaːd͡ʒɵnɵ/
ବିଭାଜିତ	/bibʱaːd͡ʒit̪ɔ/
ବିଭିନ୍ନ	/bibʱinnɵ/
ବିଭୋର	/bibʱoɾɔ/
ବିମାନ	/bimaːnɵ/
ବିରକ୍ତ	/biɾɔkt̪ɔ/
ବିରକ୍ତିକର	/biɾɔkt̪ikɔɾɔ/
ବିରଙ୍ଗ	/biɾɔŋɡɔ/
ବିରଙ୍ଗପରିବା	/biɾɔŋɡɔpɔribaː/
ବିରଜା	/biɾɵd͡ʒaː/
ବିରୟାନି	/biɾɔjaːni/
ବିରାଟ	/biraːʈɔ/
ବିରାଟ୍	/biraːʈ/
ବିରାଡ଼ି	/biraːɽi/
ବିରାଡ଼ିଟି	/biraːɽiʈi/
ବିରିୟାନି	/birijaːni/
ବିରୁଦ୍ଧରେ	/birud̪d̪ʱɵre/
ବିରୋଧ	/birod̪ʱɵ/
ବିଲ	/bilɔ/
ବିଲକୁଲ୍	/bilɔkul/
ବିଲରୁ	/bilɔru/
ବିଲୁପ୍ତ	/bilupt̪ɵ/
ବିଲେଇ	/bilei/
ବିଲେଇଛୁଆ	/bileit͡ʃʰuaː/
ବିଲେଇର	/bileiɾɔ/
ବିଲ୍	/bil/
ବିଶାକ୍ତ	/bisaːkt̪ɔ/
ବିଶାଳ	/bisaːl̪ɵ/
ବିଶିଷ୍ଟ	/bisisʈɵ/
ବିଶେଷ	/bisesɵ/
ବିଶେଷତଃ	/bisesɔt̪ɔh/
ବିଶେଷତା	/bisesɔt̪aː/
ବିଶ୍ରାମ	/bisraːmɔ/
ବିଶ୍ଵ	/bisuɵ/
ବିଶ୍ଵନାଥ	/bisuɵnaːt̪ʰɵ/
ବିଶ୍ଵବିଦ୍ୟାଳୟ	/bisuɵbid̪jaːl̪ɵjɵ/
ବିଶ୍ଵର	/bisuɵɾɵ/
ବିଶ୍ଵାଳ	/bisuaːl̪ɵ/
ବିଶ୍ଵାସ	/bisuaːsɵ/
ବିଶ୍ୱବିଦ୍ୟାଳୟ	/bisuɵbid̪jaːl̪ɵjɵ/
ବିଶ୍ୱର	/bisuɔɾɔ/
ବିଶ୍ୱରେ	/bisuɔre/
ବିଶ୍ୱାସ	/bisuaːsɵ/
ବିଷୟ	/bisɵjɵ/
ବିଷୟରେ	/bisɵjɵre/
ବିଷ୍ଣୁ	/bisɳu/
ବିସ୍କୁଟଟିଏ	/biskuʈɔʈie/
ବିସ୍ତାର	/bist̪aːɾɵ/
ବିସ୍ତୃତ	/bist̪rut̪ɔ/
ବିସ୍ମୟକର	/bismɔjɔkɔɾɔ/
ବିହନ	/bihɔnɔ/
ବିହାର	/bihaːɾɵ/
ବିହାରର	/bihaːɾɵɾɵ/
ବିହାରୀ	/bihaːri/
ବିହୀନ	/bihinɵ/
ବୀର	/biɾɵ/
ବୁଜି	/bud͡ʒi/
ବୁଝାଇ	/bud͡ʒʱaːi/
ବୁଝାଇଥାଏ	/bud͡ʒʱaːit̪ʰaːe/
ବୁଝାଇଲା	/bud͡ʒʱaːilaː/
ବୁଝାଇଲେ	/bud͡ʒʱaːile/
ବୁଝାନ୍ତି	/bud͡ʒʱaːnt̪i/
ବୁଝାବୁଝି	/bud͡ʒʱaːbud͡ʒʱi/
ବୁଝି	/bud͡ʒʱi/
ବୁଝିଗଲୁ	/bud͡ʒʱiɡɔlu/
ବୁଝିପାରିଲାନି	/bud͡ʒʱipaːrilaːni/
ବୁଝିପାରୁଛି	/bud͡ʒʱipaːrut͡ʃʰi/
ବୁଝିବା	/bud͡ʒʱibaː/
ବୁଝିଯାଇଥିବ	/bud͡ʒʱid͡ʒaːit̪ʰibɔ/
ବୁଝିଲ	/bud͡ʒʱilɔ/
ବୁଝିଲୁ	/bud͡ʒʱilu/
ବୁଝେଇ	/bud͡ʒʱei/
ବୁଝେଇଲା	/bud͡ʒʱeilaː/
ବୁଡନ୍ତି	/buɖɔnt̪i/
ବୁଡ଼ି	/buɽi/
ବୁଢା	/buɖʱaː/
ବୁଢ଼ା	/buɽʱaː/
ବୁଢୀ	/buɖʱi/
ବୁଣିବି	/buɳibi/
ବୁଦା	/bud̪aː/
ବୁଦ୍ଧ	/bud̪d̪ʱɵ/
ବୁଦ୍ଧିଆ	/bud̪d̪ʱiaː/
ବୁଦ୍ଧିମାନ୍	/bud̪d̪ʱimaːn/
ବୁଦ୍ଧୁ	/bud̪d̪ʱu/
ବୁମ୍ମ୍	/bumm/
ବୁଲନ୍ତି	/bulɔnt̪i/
ବୁଲାଇ	/bulaːi/
ବୁଲି	/buli/
ବୁଲିପଡ଼ି	/bulipɔɽi/
ବୁଲିପଡ଼ିଲେ	/bulipɔɽile/
ବୁଲିବା	/bulibaː/
ବୁଲିବାକୁ	/bulibaːku/
ବୁଲିଲେ	/bulile/
ବୁଲୁ	/bulu/
ବୁଲୁଥିବା	/bulut̪ʰibaː/
ବୁଲୁଥିଲା	/bulut̪ʰilaː/
ବୁଲୁଥିଲେ	/bulut̪ʰile/
ବୁଲୁବୁଲୁ	/bulubulu/
ବୁଲେ	/bule/
ବୁଲେଇ	/bulei/
ବୃକ୍ଷ	/brukʰjɵ/
ବୃତ୍ତି	/brut̪t̪i/
ବୃଦ୍ଧାଙ୍କୁ	/brud̪d̪ʱaːŋku/
ବୃଦ୍ଧି	/brud̪d̪ʱi/
ବୃନ୍ଦାବନ	/brund̪aːbɵnɵ/
ବୃହତ୍ତମ	/bruhɵt̪t̪ɵmɵ/
ବେକ	/bekɔ/
ବେଗ	/beɡɔ/
ବେଂଗ	/beŋɡɔ/
ବେଗମ୍	/beɡɔm/
ବେଗରେ	/beɡɵre/
ବେଙ୍ଗଳୁରୁ	/beŋɡɔl̪uru/
ବେଙ୍ଗାଳୁରୁ	/beŋgaːl̪uru/
ବେଞ୍ଚ	/beɲt͡ʃɔ/
ବେଣା	/beɳaː/
ବେଣୀ	/beɳi/
ବେଦ	/bed̪ɵ/
ବେଲଟ୍	/belɔʈ/
ବେଲ୍‌	/bel/
ବେଳ	/bel̪ɔ/
ବେଳକି	/bel̪ɔki/
ବେଳକୁ	/bel̪ɵku/
ବେଳାଭୂମି	/bel̪aːbʱumi/
ବେଳେ	/bel̪e/
ବେଳେବେଳେ	/bel̪ebel̪e/
ବେଳେବେଳେଏହି	/bel̪ebel̪eehi/
ବେଶ	/besɵ/
ବେଶରେ	/besɵre/
ବେଶି	/besi/
ବେଶୀ	/besi/
ବେସିନ୍	/besin/
ବେହେରା	/beheraː/
ବୈଜ୍ଞାନିକ	/bɵid͡ʒɲaːnikɵ/
ବୈଠକଖାନା	/bɔiʈʰɔkɔkʰaːnaː/
ବୈତରଣୀ	/bɵit̪ɵɾɵɳi/
ବୈଧ	/bɵid̪ʱɵ/
ବୈଶାଖ	/bɵisaːkʰɵ/
ବୈଷୟିକ	/bɵisɵjikɵ/
ବୈଷ୍ଣବ	/bɵisɳɵbɵ/
ବୋଉ	/bou/
ବୋକା	/bokaː/
ବୋକାଙ୍କ	/bokaːŋkɔ/
ବୋକାଟି	/bokaːʈi/
ବୋକାମୀ	/bokaːmi/
ବୋଝ	/bod͡ʒʱɔ/
ବୋତଲ	/bot̪ɔlɔ/
ବୋତଲଟିର	/bot̪ɔlɔʈiɾɔ/
ବୋତଲ୍	/bot̪ɔl/
ବୋଧହୁଏ	/bod̪ʱɔhue/
ବୋଧେ	/bod̪ʱe/
ବୋବାଉଥିଲେ	/bobaːut̪ʰile/
ବୋର୍ଡ଼	/borɖɵ/
ବୋର୍ଡ଼ରେ	/borɽɔre/
ବୋଲି	/boli/
ବୋଲିଲା	/bolilaː/
ବୋଷ	/bosɵ/
ବୋହି	/bohi/
ବୋହିନେଉଥିବା	/bohineut̪ʰibaː/
ବୋହିଯିବ	/bohid͡ʒibɔ/
ବୋହୁଛି	/bohut͡ʃʰi/
ବୋହୁଥିଲା	/bohut̪ʰilaː/
ବୌଦ୍ଧ	/boud̪d̪ʱɵ/
ବ୍ୟକ୍ତି	/bjɵkt̪i/
ବ୍ୟକ୍ତିଗଣ	/bjɔkt̪iɡɔɳɔ/
ବ୍ୟକ୍ତିଗତ	/bjɵkt̪iɡɵt̪ɵ/
ବ୍ୟଞନ	/bjɔɲɔnɔ/
ବ୍ୟଞ୍ଜନ	/bjɵɲd͡ʒɵnɵ/
ବ୍ୟତିତ	/bjɵt̪it̪ɵ/
ବ୍ୟତିବ୍ୟସ୍ତ	/bjɔt̪ibjɔst̪ɔ/
ବ୍ୟତୀତ	/bjɵt̪it̪ɵ/
ବ୍ୟବସାୟ	/bjɔbɔsaːjɔ/
ବ୍ୟବସ୍ଥା	/bjɵbɵst̪ʰaː/
ବ୍ୟବହାର	/bjɵbɵhaːɾɵ/
ବ୍ୟବହାରକାରୀ	/bjɵbɵhaːɾɵkaːri/
ବ୍ୟବହାରକାରୀଙ୍କ	/bjɵbɵhaːɾɵkaːriŋkɵ/
ବ୍ୟବହାରରେ	/bjɔbɔhaːɾɔre/
ବ୍ୟବହୃତ	/bjɵbɵhɵrut̪ɵ/
ବ୍ୟର୍ଥ	/bjɔrt̪ʰɔ/
ବ୍ୟସ୍ତ	/bjɔst̪ɔ/
ବ୍ୟାକୁଳ	/bjaːkul̪ɔ/
ବ୍ୟାଗ୍	/bjaːg/
ବ୍ୟାଟ	/bjaːʈɔ/
ବ୍ୟାଣ୍ଡ୍	/bjaːɳɖ/
ବ୍ୟାପିବାକୁ	/bjaːpibaːku/
ବ୍ୟାୟାମ	/bjaːjaːmɵ/
ବ୍ରତ	/bɾɵt̪ɵ/
ବ୍ରସ୍	/bɾɔs/
ବ୍ରହ୍ମପୁର	/bɾɵhmɵpuɾɵ/
ବ୍ରହ୍ମା	/bɾɵhmaː/
ବ୍ରାହ୍ମଣ	/braːhmɵɳɵ/
ବ୍ରିଟିଶ	/briʈisɵ/
ବ୍ଲକ	/blɵkɵ/
ବ୍ଲକ୍	/blɔk/
ବ୍ଳକ	/bl̪ɵkɵ/
ବ୍ଳକର	/bl̪ɵkɵɾɵ/
ଭଃ	/bʰɔh/
ଭଉଣୀ	/bʰɵuɳi/
ଭଉଣୀର	/bʰɔuɳiɾɔ/
ଭକ୍ତ	/bʰɵkt̪ɵ/
ଭକ୍ତମାନେ	/bʰɵkt̪ɵmaːne/
ଭକ୍ତି	/bʰɵkt̪i/
ଭଗବାନ	/bʰɵɡɵbaːnɵ/
ଭଗାଂଘର	/bʰɔgaːŋɡʱɔɾɔ/
ଭଗ୍ନ	/bʰɵgnɵ/
ଭଙ୍ଗା	/bʰɔŋgaː/
ଭଜନ	/bʰɵd͡ʒɵnɵ/
ଭଜା	/bʰɵd͡ʒaː/
ଭଞ୍ଜ	/bʰɵɲd͡ʒɵ/
ଭଦ୍ରକ	/bʰɵd̪ɾɵkɵ/
ଭୟ	/bʰɔjɔ/
ଭୟଂକର	/bʰɔjɔŋkɔɾɔ/
ଭୟଙ୍କର	/bʰɔjɔŋkɔɾɔ/
ଭରା	/bʰɔraː/
ଭରାଦେଇ	/bʰɔraːd̪ei/
ଭରାଯାଏ	/bʰɔraːd͡ʒaːe/
ଭରି	/bʰɔri/
ଭରିଗଲା	/bʰɔriɡɔlaː/
ଭରିଚାଲିଲା	/bʰɔrit͡ʃaːlilaː/
ଭରିଯାଇଥିଲା	/bʰɔrid͡ʒaːit̪ʰilaː/
ଭରୁ	/bʰɔru/
ଭର୍ତ୍ତା	/bʰɔrt̪t̪aː/
ଭର୍ତ୍ତି	/bʰɔrt̪t̪i/
ଭଲ	/bʰɵlɵ/
ଭଲପାଆନ୍ତି	/bʰɔlɔpaːaːnt̪i/
ଭଲପାଏ	/bʰɔlɔpaːe/
ଭଲପାନ୍ତି	/bʰɔlɔpaːnt̪i/
ଭଲଭାବେ	/bʰɔlɔbʱaːbe/
ଭଲରେ	/bʰɔlɔre/
ଭଲଲାଗୁ	/bʰɔlɔlaːgu/
ଭଲଲାଗେ	/bʰɔlɔlaːge/
ଭଲଲାଗେନି	/bʰɔlɔlaːgeni/
ଭଲା	/bʰɔlaː/
ଭଲିଆ	/bʰɔliaː/
ଭଳି	/bʰɵl̪i/
ଭଳିଆ	/bʰɔl̪iaː/
ଭସେଇବି	/bʰɔseibi/
ଭାଇ	/bʱaːi/
ଭାଇକୁ	/bʱaːiku/
ଭାଇସରୟଙ୍କୁ	/bʱaːisɔɾɔjɔŋku/
ଭାଗ	/bʱaːɡɵ/
ଭାଗବତ	/bʱaːɡɵbɵt̪ɵ/
ଭାଗରେ	/bʱaːɡɵre/
ଭାଂଗିବା	/bʱaːŋgibaː/
ଭାଂଗିବାର	/bʱaːŋgibaːɾɔ/
ଭାଂଗିଲା	/bʱaːŋgilaː/
ଭାଂଗୀ	/bʱaːŋgi/
ଭାଂଗେନି	/bʱaːŋgeni/
ଭାଗ୍ୟ	/bʱaːgjɔ/
ଭାଗ୍ୟବାନ	/bʱaːgjɔbaːnɔ/
ଭାଙ୍ଗ	/bʱaːŋɡɔ/
ଭାଙ୍ଗି	/bʱaːŋgi/
ଭାଙ୍ଗିକି	/bʱaːŋgiki/
ଭାଙ୍ଗିଦେଲେ	/bʱaːŋgid̪ele/
ଭାଙ୍ଗିବା	/bʱaːŋgibaː/
ଭାଜ	/bʱaːd͡ʒɔ/
ଭାଜପା	/bʱaːd͡ʒɵpaː/
ଭାଜି	/bʱaːd͡ʒi/
ଭାଜିବାକୁ	/bʱaːd͡ʒibaːku/
ଭାତ	/bʱaːt̪ɔ/
ଭାଦ୍ରବ	/bʱaːd̪ɾɵbɵ/
ଭାବ	/bʱaːbɵ/
ଭାବନା	/bʱaːbɔnaː/
ଭାବନାରେ	/bʱaːbɔnaːre/
ଭାବରେ	/bʱaːbɵre/
ଭାବି	/bʱaːbi/
ଭାବିପାରୁ	/bʱaːbipaːru/
ଭାବିପାରୁଛ	/bʱaːbipaːrut͡ʃʰɔ/
ଭାବିବାକୁ	/bʱaːbibaːku/
ଭାବିଲା	/bʱaːbilaː/
ଭାବିଲେ	/bʱaːbile/
ଭାବୁଛ	/bʱaːbut͡ʃʰɔ/
ଭାବୁଛନ୍ତି	/bʱaːbut͡ʃʰɔnt̪i/
ଭାବୁଛି	/bʱaːbut͡ʃʰi/
ଭାବୁଥିବ	/bʱaːbut̪ʰibɔ/
ଭାବୁଥିବା	/bʱaːbut̪ʰibaː/
ଭାବୁଥିଲା	/bʱaːbut̪ʰilaː/
ଭାବୁଥିଲେ	/bʱaːbut̪ʰile/
ଭାବେ	/bʱaːbe/
ଭାରତ	/bʱaːɾɵt̪ɵ/
ଭାରତର	/bʱaːɾɵt̪ɵɾɵ/
ଭାରତରୁ	/bʱaːɾɔt̪ɔru/
ଭାରତରେ	/bʱaːɾɵt̪ɵre/
ଭାରତୀୟ	/bʱaːɾɵt̪ijɵ/
ଭାରି	/bʱaːri/
ଭାଲୁ	/bʱaːlu/
ଭାଷଣ	/bʱaːsɔɳɔ/
ଭାଷା	/bʱaːsaː/
ଭାଷାକୋଷ	/bʱaːsaːkosɵ/
ଭାଷାର	/bʱaːsaːɾɵ/
ଭାଷାରେ	/bʱaːsaːre/
ଭାସି	/bʱaːsi/
ଭାସିପାର	/bʱaːsipaːɾɔ/
ଭାସିବାକୁ	/bʱaːsibaːku/
ଭାସୁଛି	/bʱaːsut͡ʃʰi/
ଭି	/bʱi/
ଭିକି	/bʱiki/
ଭିଜା	/bʱid͡ʒaː/
ଭିଜାଇ	/bʱid͡ʒaːi/
ଭିଜି	/bʱid͡ʒi/
ଭିଜେଇ	/bʱid͡ʒei/
ଭିଟାମିନ	/bʱiʈaːminɵ/
ଭିଡ଼	/bʱiɽɔ/
ଭିଡ଼ଥାଏ	/bʱiɽɔt̪ʰaːe/
ଭିଡ଼ି	/bʱiɽi/
ଭିଡିଓ	/bʱiɖio/
ଭିଡ଼ିକି	/bʱiɽiki/
ଭିଡ଼ିବାରେ	/bʱiɽibaːre/
ଭିତର	/bʱit̪ɵɾɵ/
ଭିତରକୁ	/bʱit̪ɵɾɵku/
ଭିତରୁ	/bʱit̪ɵru/
ଭିତରେ	/bʱit̪ɵre/
ଭିନ୍ନ	/bʱinnɵ/
ଭୀମା	/bʱimaː/
ଭୀମାର	/bʱimaːɾɔ/
ଭୀଷଣ	/bʱisɔɳɔ/
ଭୁକି	/bʱuki/
ଭୁତାଣୁ	/bʱut̪aːɳu/
ଭୁବନେଶ୍ଵର	/bʱubɵnesuɵɾɵ/
ଭୁବନେଶ୍ୱର	/bʱubɵnesuɵɾɵ/
ଭୁଲ	/bʱulɵ/
ଭୁଲିଗଲ	/bʱuliɡɔlɔ/
ଭୁଲ୍	/bʱul/
ଭୂଖଣ୍ଡ	/bʱukʰɵɳɖɵ/
ଭୂଗୋଳ	/bʱugol̪ɵ/
ଭୂମି	/bʱumi/
ଭୂମିକା	/bʱumikaː/
ଭୂଷଣ	/bʱusɵɳɵ/
ଭେଟ	/bʱeʈɔ/
ଭେଟିବ	/bʱeʈibɔ/
ଭେଟିବା	/bʱeʈibaː/
ଭେଟିବି	/bʱeʈibi/
ଭେଟିଲା	/bʱeʈilaː/
ଭେଣ୍ଡି	/bʱeɳɖi/
ଭେନୁ	/bʱenu/
ଭେଷଜ	/bʱesɵd͡ʒɵ/
ଭୋ	/bʱo/
ଭୋଅଅଅ	/bʱoɔɔɔ/
ଭୋଓଓ	/bʱooo/
ଭୋକ	/bʱokɔ/
ଭୋକି	/bʱoki/
ଭୋଗ	/bʱoɡɵ/
ଭୋଜନ	/bʱod͡ʒɔnɔ/
ଭୋଜି	/bʱod͡ʒi/
ଭୋଟ	/bʱoʈɵ/
ଭୋଟର	/bʱoʈɵɾɵ/
ଭୋରରୁ	/bʱoɾɔru/
ଭୌଂ	/bʱɔuŋ/
ଭୌତିକ	/bʱout̪ikɵ/
ଭ୍ରମଣ	/bʱɾɵmɵɳɵ/
ଭ୍ରମର	/bʱɾɔmɔɾɔ/
ମଇ	/mɵi/
ମଇଳ	/mɔil̪ɔ/
ମକଚିଲା	/mɔkɔt͡ʃilaː/
ମକର	/mɵkɵɾɵ/
ମକ୍କା	/mɔkkaː/
ମଙ୍ଗଳ	/mɵŋɡɵl̪ɵ/
ମଙ୍ଗଳବାର	/mɵŋɡɵl̪ɵbaːɾɵ/
ମଙ୍ଗଳା	/mɵŋɡɵl̪aː/
ମଜବୁତ	/mɔd͡ʒɔbut̪ɔ/
ମଜବୁତ୍‌	/mɔd͡ʒɔbut̪/
ମଜା	/mɔd͡ʒaː/
ମଜାକିଆ	/mɔd͡ʒaːkiaː/
ମଜାରେ	/mɔd͡ʒaːre/
ମଜାଲାଗେ	/mɔd͡ʒaːlaːge/
ମଜାଳିଆ	/mɔd͡ʒaːl̪iaː/
ମଜ୍ଜା	/mɔd͡ʒd͡ʒaː/
ମଝିଭାଗରେ	/mɔd͡ʒʱibʱaːɡɔre/
ମଝିରେ	/mɵd͡ʒʱire/
ମଞି	/mɔɲi/
ମଞ୍ଚର	/mɔɲt͡ʃɔɾɔ/
ମଞ୍ଚସ୍ଥ	/mɔɲt͡ʃɔst̪ʰɔ/
ମଞ୍ଜି	/mɵɲd͡ʒi/
ମଟର	/mɔʈɔɾɔ/
ମଟରସାଇକେଲ	/mɔʈɔɾɔsaːikelɔ/
ମଠ	/mɵʈʰɵ/
ମଣି	/mɵɳi/
ମଣିପୁରୀ	/mɔɳipuri/
ମଣିମା	/mɔɳimaː/
ମଣିମାଙ୍କ	/mɔɳimaːŋkɔ/
ମଣିମାଙ୍କୁ	/mɔɳimaːŋku/
ମଣିଷ	/mɵɳisɵ/
ମଣିଷମାନଙ୍କ	/mɔɳisɔmaːnɔŋkɔ/
ମଣିଷମାନେ	/mɔɳisɔmaːne/
ମଣ୍ଡପ	/mɵɳɖɵpɵ/
ମଣ୍ଡଳ	/mɵɳɖɵl̪ɵ/
ମଣ୍ଡଳି	/mɵɳɖɵl̪i/
ମଣ୍ଡଳୀ	/mɵɳɖɵl̪i/
ମଣ୍ଡେଲା	/mɵɳɖelaː/
ମତ	/mɵt̪ɵ/
ମତରେ	/mɵt̪ɵre/
ମତାମତ	/mɵt̪aːmɵt̪ɵ/
ମତେ	/mɵt̪e/
ମଧୁର	/mɔd̪ʱuɾɔ/
ମଧୁସୂଦନ	/mɵd̪ʱusud̪ɵnɵ/
ମଧ୍ୟ	/mɵd̪ʱjɵ/
ମଧ୍ୟମ	/mɵd̪ʱjɵmɵ/
ମଧ୍ୟରୁ	/mɵd̪ʱjɵru/
ମଧ୍ୟରେ	/mɵd̪ʱjɵre/
ମନ	/mɵnɵ/
ମନକୁ	/mɔnɔku/
ମନଦୁଃଖ	/mɔnɔd̪uhkʰɔ/
ମନଦୁଃଖରେ	/mɔnɔd̪uhkʰɔre/
ମନମତାଣିଆ	/mɔnɔmɔt̪aːɳiaː/
ମନମୋହକ	/mɔnɔmohɔkɔ/
ମନମୋହନ	/mɵnɵmohɵnɵ/
ମନା	/mɔnaː/
ମନାନ୍ତି	/mɔnaːnt̪i/
ମନୁ	/mɔnu/
ମନୁଆ	/mɔnuaː/
ମନୁଆକୁ	/mɔnuaːku/
ମନୁଆର	/mɔnuaːɾɔ/
ମନୁଷ୍ୟ	/mɵnusjɵ/
ମନେ	/mɵne/
ମନେପଡ଼ିଲା	/mɔnepɔɽilaː/
ମନେରଖ	/mɔneɾɔkʰɔ/
ମନେହୁଏ	/mɔnehue/
ମନୋଜ	/mɵnod͡ʒɵ/
ମନୋନୟନ	/mɵnonɵjɵnɵ/
ମନୋରଞ୍ଜନ	/mɵnoɾɵɲd͡ʒɵnɵ/
ମନୋରମ	/mɔnoɾɔmɔ/
ମନ୍ତ୍ର	/mɵnt̪ɾɵ/
ମନ୍ତ୍ରୀ	/mɵnt̪ri/
ମନ୍ଦିର	/mɵnd̪iɾɵ/
ମନ୍ଦିରର	/mɵnd̪iɾɵɾɵ/
ମନ୍ଦିରରେ	/mɵnd̪iɾɵre/
ମଫଲର	/mɔpʰɔlɔɾɔ/
ମମତା	/mɵmɵt̪aː/
ମୟ	/mɔjɔ/
ମୟୁର	/mɔjuɾɔ/
ମୟୁୁର	/mɔjuɾɔ/
ମୟୂର	/mɔjuɾɔ/
ମୟୂରଭଞ୍ଜ	/mɵjuɾɵbʰɵɲd͡ʒɵ/
ମରାଠି	/mɵraːʈʰi/
ମରାମତି	/mɔraːmɔt̪i/
ମରିଗଲିଣି	/mɔriɡɔliɳi/
ମରିଚ	/mɔrit͡ʃɔ/
ମରୁଭୂମିର	/mɔrubʱumiɾɔ/
ମଲହାର	/mɔlɔhaːɾɔ/
ମଲ୍ଲିକ	/mɵllikɵ/
ମଷ୍ତିଷ୍କ	/mɔst̪iskɔ/
ମଷ୍ତିସ୍କ	/mɔst̪iskɔ/
ମସଲା	/mɵsɵlaː/
ମସିହା	/mɵsihaː/
ମସିହାର	/mɵsihaːɾɵ/
ମସିହାରୁ	/mɵsihaːru/
ମସିହାରେ	/mɵsihaːre/
ମସ୍ତିଷ୍କ	/mɵst̪iskɵ/
ମହକୁମା	/mɵhɵkumaː/
ମହତାବ	/mɵhɵt̪aːbɵ/
ମହମବତୀ	/mɔhɔmɔbɔt̪i/
ମହମ୍ମଦ	/mɵhɵmmɵd̪ɵ/
ମହଲାରୁ	/mɔhɔlaːru/
ମହା	/mɵhaː/
ମହାକାଶ	/mɵhaːkaːsɵ/
ମହାଦେବ	/mɵhaːd̪ebɵ/
ମହାଦେଶ	/mɵhaːd̪esɵ/
ମହାଦେଶରେ	/mɔhaːd̪esɔre/
ମହାନ	/mɵhaːnɵ/
ମହାନଦୀ	/mɵhaːnɵd̪i/
ମହାନ୍ତି	/mɵhaːnt̪i/
ମହାପାତ୍ର	/mɵhaːpaːt̪ɾɵ/
ମହାପ୍ରଭୁ	/mɵhaːpɾɵbʱu/
ମହାପ୍ରଭୁଙ୍କ	/mɵhaːpɾɵbʱuŋkɵ/
ମହାବିଦ୍ୟାଳୟ	/mɵhaːbid̪jaːl̪ɵjɵ/
ମହାଭାରତ	/mɵhaːbʱaːɾɵt̪ɵ/
ମହାମହିମ	/mɔhaːmɔhimɔ/
ମହାରଣା	/mɵhaːɾɵɳaː/
ମହାରାଜ	/mɔhaːraːd͡ʒɔ/
ମହାରାଜଙ୍କ	/mɔhaːraːd͡ʒɔŋkɔ/
ମହାରାଜା	/mɵhaːraːd͡ʒaː/
ମହାରାଷ୍ଟ୍ର	/mɵhaːraːsʈɾɵ/
ମହାରାଷ୍ଟ୍ରର	/mɵhaːraːsʈɾɵɾɵ/
ମହାଶୟ	/mɔhaːsɔjɔ/
ମହାଶ୍ୱେତା	/mɵhaːsuet̪aː/
ମହିମା	/mɵhimaː/
ମହିଳା	/mɵhil̪aː/
ମହୁ	/mɵhu/
ମହୁଫେଣ	/mɔhupʰeɳɔ/
ମହୁଫେଣା	/mɔhupʰeɳaː/
ମହୁମାଛି	/mɔhumaːt͡ʃʰi/
ମହୁମାଛିଙ୍କୁ	/mɔhumaːt͡ʃʰiŋku/
ମା	/maː/
ମାଁ	/maː̃/
ମା-ବିଲେଇ	/maː-bilei/
ମାଆ	/maːaː/
ମାଆକୁ	/maːaːku/
ମାଆଙ୍କ	/maːaːŋkɔ/
ମାଆମାନେ	/maːaːmaːne/
ମାଆର	/maːaːɾɔ/
ମାଇଁ	/maːĩ/
ମାଉସ	/maːusɵ/
ମାଉସୀ	/maːusi/
ମାଂକଡ଼	/maːŋkɔɽɔ/
ମାଗିଲେ	/maːgile/
ମାଘ	/maːɡʱɵ/
ମାଙ୍କ	/maːŋkɔ/
ମାଙ୍କଡ଼	/maːŋkɔɽɔ/
ମାଙ୍କଡ଼ଟିଏ	/maːŋkɔɽɔʈie/
ମାଙ୍କଡ଼ାଚିତ୍	/maːŋkɔɽaːt͡ʃit̪/
ମାଛ	/maːt͡ʃʰɵ/
ମାଛକୁ	/maːt͡ʃʰɔku/
ମାଛଙ୍କୁବି	/maːt͡ʃʰɔŋkubi/
ମାଛଟିଏ	/maːt͡ʃʰɔʈie/
ମାଛମାନେ	/maːt͡ʃʰɔmaːne/
ମାଛି	/maːt͡ʃʰi/
ମାଛିଙ୍କ	/maːt͡ʃʰiŋkɔ/
ମାଝି	/maːd͡ʒʱi/
ମାଟି	/maːʈi/
ମାଟିଆ	/maːʈiaː/
ମାଟିର	/maːʈiɾɔ/
ମାଟିରୁ	/maːʈiru/
ମାଟିରେ	/maːʈire/
ମାଡ଼	/maːɽɔ/
ମାଡ଼ଗୋଳ	/maːɽɔgol̪ɔ/
ମାଡ଼ି	/maːɽi/
ମାଢି	/maːɖʱi/
ମାଢ଼ିକୁ	/maːɽʱiku/
ମାତା	/maːt̪aː/
ମାତାପିତା	/maːt̪aːpit̪aː/
ମାତ୍ର	/maːt̪ɾɵ/
ମାତ୍ରା	/maːt̪raː/
ମାତ୍ରେ	/maːt̪re/
ମାଧବ	/maːd̪ʱɵbɵ/
ମାଧ୍ୟମରେ	/maːd̪ʱjɵmɵre/
ମାଧ୍ୟମିକ	/maːd̪ʱjɵmikɵ/
ମାନ	/maːnɵ/
ମାନଂକ	/maːnɔŋkɔ/
ମାନକ	/maːnɵkɵ/
ମାନଂକୁ	/maːnɔŋku/
ମାନଙ୍କ	/maːnɵŋkɵ/
ମାନଙ୍କର	/maːnɵŋkɵɾɵ/
ମାନଙ୍କରେ	/maːnɵŋkɵre/
ମାନଙ୍କୁ	/maːnɵŋku/
ମାନଚିତ୍ର	/maːnɵt͡ʃit̪ɾɵ/
ମାନବ	/maːnɵbɵ/
ମାନସିକ	/maːnɵsikɵ/
ମାନୁ	/maːnu/
ମାନୁଛି	/maːnut͡ʃʰi/
ମାନେ	/maːne/
ମାନ୍ୟତା	/maːnjɵt̪aː/
ମାପ	/maːpɵ/
ମାପି	/maːpi/
ମାପିକି	/maːpiki/
ମାମୁ	/maːmu/
ମାମୁଁ	/maːmũ/
ମାରନ୍ତି	/maːɾɔnt̪i/
ମାରି	/maːri/
ମାରିଦେବାକୁ	/maːrid̪ebaːku/
ମାରିପାରନ୍ତି	/maːripaːɾɔnt̪i/
ମାରିବା	/maːribaː/
ମାରିବାକୁ	/maːribaːku/
ମାରିବି	/maːribi/
ମାରିବେ	/maːribe/
ମାରିଲା	/maːrilaː/
ମାରିଲେ	/maːrile/
ମାରୁ	/maːru/
ମାରୁଥିଲା	/maːrut̪ʰilaː/
ମାର୍ଚ	/maːrt͡ʃɵ/
ମାର୍ଚ୍ଚ	/maːrt͡ʃt͡ʃɵ/
ମାଲକାନଗିରି	/maːlɵkaːnɵgiri/
ମାଲୟାଲମ	/maːlɵjaːlɵmɵ/
ମାଲିକାଣୀ	/maːlikaːɳi/
ମାଲୁ	/maːlu/
ମାଳୀ	/maːl̪i/
ମାଳୁ	/maːl̪u/
ମାଶାଆଲ୍ଲାହ	/maːsaːaːllaːhɔ/
ମାଷ୍ଟ୍ରେ	/maːsʈre/
ମାଷ୍ଟ୍ରେଙ୍କ	/maːsʈreŋkɔ/
ମାଷ୍ଟ୍ରେଙ୍କର	/maːsʈreŋkɔɾɔ/
ମାଷ୍ଟ୍ରେଙ୍କୁ	/maːsʈreŋku/
ମାଂସ	/maːŋsɵ/
ମାସ	/maːsɵ/
ମାଂସପେଶୀ	/maːŋsɵpesi/
ମାସର	/maːsɵɾɵ/
ମାସରେ	/maːsɵre/
ମାଂସାଶୀ	/maːŋsaːsi/
ମାସିକ	/maːsikɵ/
ମାସେ	/maːse/
ମାହାତ୍ମାଗାନ୍ଧୀ	/maːhaːt̪maːgaːnd̪ʱi/
ମାହାତ୍ମାଗାନ୍ଧୀଙ୍କ	/maːhaːt̪maːgaːnd̪ʱiŋkɔ/
ମାହାତ୍ମାଗାନ୍ଧୀଙ୍କର	/maːhaːt̪maːgaːnd̪ʱiŋkɔɾɔ/
ମାହାତ୍ମାଜୀ	/maːhaːt̪maːd͡ʒi/
ମି	/mi/
ମିଆଁ	/miaː̃/
ମିଆଁଉ	/miaː̃u/
ମିକ୍	/mik/
ମିଟର	/miʈɵɾɵ/
ମିଠା	/miʈʰaː/
ମିଠା-ମିଠା	/miʈʰaː-miʈʰaː/
ମିଠାର	/miʈʰaːɾɔ/
ମିଠେଇ-ରସଗୋଲା	/miʈʰei-ɾɔsɔgolaː/
ମିନିଟ	/miniʈɵ/
ମିନିଟ୍‌	/miniʈ/
ମିନିଟ୍	/miniʈ/
ମିଳାଅ	/mil̪aːɔ/
ମିଳାଇ	/mil̪aːi/
ମିଳାମିଶା	/mil̪aːmisaː/
ମିଳି	/mil̪i/
ମିଳିଗଲା	/mil̪iɡɔlaː/
ମିଳିଛି	/mil̪it͡ʃʰi/
ମିଳିତ	/mil̪it̪ɵ/
ମିଳିଥାଏ	/mil̪it̪ʰaːe/
ମିଳିଥିଲା	/mil̪it̪ʰilaː/
ମିଳିବ	/mil̪ibɔ/
ମିଳିମିଶି	/mil̪imisi/
ମିଳିଯିବ	/mil̪id͡ʒibɔ/
ମିଳିଲା	/mil̪ilaː/
ମିଳିଲେ	/mil̪ile/
ମିଳୁଛି	/mil̪ut͡ʃʰi/
ମିଳୁଥିବା	/mil̪ut̪ʰibaː/
ମିଳେ	/mil̪e/
ମିଶାଇ	/misaːi/
ମିଶାଏ	/misaːe/
ମିଶି	/misi/
ମିଶେଇ	/misei/
ମିଶ୍ର	/misɾɵ/
ମିସ୍	/mis/
ମିସ୍‌	/mis/
ମିହିର	/mihiɾɵ/
ମୀନୁ	/minu/
ମୀରା	/miraː/
ମୁ	/mu/
ମୁଁ	/mũ/
ମୁକ୍ତ	/mukt̪ɵ/
ମୁକ୍ତି	/mukt̪i/
ମୁକ୍ତିଲାଭ	/mukt̪ilaːbʰɵ/
ମୁଖ	/mukʰɵ/
ମୁଖି	/mukʰi/
ମୁଖିଟେ	/mukʰiʈe/
ମୁଖ୍ୟ	/mukʰjɵ/
ମୁଖ୍ୟମନ୍ତ୍ରୀ	/mukʰjɵmɵnt̪ri/
ମୁଗ୍ଗୁ	/muggu/
ମୁଚକ	/mut͡ʃɔkɔ/
ମୁଚକକୁ	/mut͡ʃɔkɔku/
ମୁଢ଼ୀ	/muɽʱi/
ମୁଣି	/muɳi/
ମୁଣ୍ଡ	/muɳɖɵ/
ମୁଣ୍ଡକୁ	/muɳɖɔku/
ମୁଣ୍ଡଟା	/muɳɖɔʈaː/
ମୁଣ୍ଡଟି	/muɳɖɔʈi/
ମୁଣ୍ଡଭିତରେ	/muɳɖɔbʱit̪ɔre/
ମୁଣ୍ଡରେ	/muɳɖɔre/
ମୁଣ୍ଡା	/muɳɖaː/
ମୁଣ୍ଡିଆ	/muɳɖiaː/
ମୁଣ୍ତ	/muɳt̪ɔ/
ମୁଣ୍ତକୁ	/muɳt̪ɔku/
ମୁଦ୍ରା	/mud̪raː/
ମୁନିଆ	/muniaː/
ମୁନିଆଁ	/muniaː̃/
ମୁନ୍ନୀକୁ	/munniku/
ମୁବାରକ	/mubaːɾɔkɔ/
ମୁମ୍ବାଇ	/mumbaːi/
ମୁସଲମାନ	/musɵlɵmaːnɵ/
ମୁହଁ	/muhɔ̃/
ମୁଁହ	/mũhɔ/
ମୁହଁକୁ	/muhɔ̃ku/
ମୁହଁଟା	/muhɔ̃ʈaː/
ମୁହଁରେ	/muhɔ̃re/
ମୁହାଁ	/muhaː̃/
ମୁହେଁଇଲା	/muhẽilaː/
ମୂଖ୍ୟ	/mukʰjɵ/
ମୂନିଆ	/muniaː/
ମୂର୍ତ୍ତି	/murt̪t̪i/
ମୂଲ୍ୟ	/muljɵ/
ମୂଲ୍ୟବାନ	/muljɔbaːnɔ/
ମୂଳ	/mul̪ɵ/
ମୂଷା	/musaː/
ମୂହୁର୍ତ୍ତ	/muhurt̪t̪ɔ/
ମୃ-ଦ-ଙ୍ଗ-ମ	/mru-d̪ɔ-ŋɡɔ-mɔ/
ମୃତ୍ୟୁ	/mrut̪ju/
ମୃତ୍ୟୁଞ୍ଜୟ	/mrut̪juɲd͡ʒɵjɵ/
ମୃଦଙ୍ଗମ	/mrud̪ɔŋɡɔmɔ/
ମେ	/me/
ମେଘ	/meɡʱɔ/
ମେଘାଲୟ	/megʰaːlɵjɵ/
ମେଲାଇ	/melaːi/
ମେଲେଇ	/melei/
ମେଲେଇଦିଅ	/meleid̪iɔ/
ମେଳ	/mel̪ɔ/
ମେଳଣ	/mel̪ɵɳɵ/
ମେଳା	/mel̪aː/
ମେସୋଜୋଇକ	/mesod͡ʒoikɵ/
ମେହେର	/meheɾɵ/
ମୋ	/mo/
ମୋଇଦୁତ୍ତି	/moid̪ut̪t̪i/
ମୋଗଲ	/moɡɵlɵ/
ମୋଗଲାଇ	/moɡɔlaːi/
ମୋଟ	/moʈɵ/
ମୋଟା	/moʈaː/
ମୋଟେ	/moʈe/
ମୋଠୁଁ	/moʈʰũ/
ମୋଡ଼ି	/moɽi/
ମୋଡ଼ିଦେଲା	/moɽid̪elaː/
ମୋତି	/mot̪i/
ମୋତେ	/mot̪e/
ମୋବାଇଲ	/mobaːilɔ/
ମୋର	/moɾɵ/
ମୋରେ	/more/
ମୋହନ	/mohɵnɵ/
ମୋହମବତୀ	/mohɔmɔbɔt̪i/
ମୌଳିକ	/moul̪ikɵ/
ମ୍ୟାଜିକ	/mjaːd͡ʒikɔ/
ମ୍ୟାଜିକ୍	/mjaːd͡ʒik/
ମ୍ୟାଲେରିଆ	/mjaːleriaː/
ଯକୃତ	/d͡ʒɵkrut̪ɵ/
ଯକ୍ଷ୍ମା	/d͡ʒɵkʰmaː/
ଯତ୍ନ	/d͡ʒɔt̪nɔ/
ଯତ୍ନର	/d͡ʒɔt̪nɔɾɔ/
ଯତ୍ନରେ	/d͡ʒɔt̪nɔre/
ଯଥା	/d͡ʒɵt̪ʰaː/
ଯଥେଷ୍ଟ	/d͡ʒɵt̪ʰesʈɵ/
ଯଦି	/d͡ʒɵd̪i/
ଯଦିଓ	/d͡ʒɵd̪io/
ଯନ୍ତ୍ର	/d͡ʒɵnt̪ɾɵ/
ଯନ୍ତ୍ରଣା	/d͡ʒɵnt̪ɾɵɳaː/
ଯବକାଚ	/d͡ʒɔbɔkaːt͡ʃɔ/
ଯବକାଚଟିଏ	/d͡ʒɔbɔkaːt͡ʃɔʈie/
ଯା	/d͡ʒaː/
ଯାଅ	/d͡ʒaːɔ/
ଯାଆ	/d͡ʒaːaː/
ଯାଆନ୍ତି	/d͡ʒaːaːnt̪i/
ଯାଆଁଳା	/d͡ʒaːaː̃l̪aː/
ଯାଇ	/d͡ʒaːi/
ଯାଇଛନ୍ତି	/d͡ʒaːit͡ʃʰɔnt̪i/
ଯାଇଛି	/d͡ʒaːit͡ʃʰi/
ଯାଇଥାଏ	/d͡ʒaːit̪ʰaːe/
ଯାଇଥିବା	/d͡ʒaːit̪ʰibaː/
ଯାଇଥିଲା	/d͡ʒaːit̪ʰilaː/
ଯାଇଥିଲେ	/d͡ʒaːit̪ʰile/
ଯାଇପାରନ୍ତି	/d͡ʒaːipaːɾɔnt̪i/
ଯାଇପାରିବେ	/d͡ʒaːipaːribe/
ଯାଇପାରେ	/d͡ʒaːipaːre/
ଯାଉ	/d͡ʒaːu/
ଯାଉଚୁ	/d͡ʒaːut͡ʃu/
ଯାଉଛ	/d͡ʒaːut͡ʃʰɔ/
ଯାଉଛନ୍ତି	/d͡ʒaːut͡ʃʰɔnt̪i/
ଯାଉଛି	/d͡ʒaːut͡ʃʰi/
ଯାଉଛୁ	/d͡ʒaːut͡ʃʰu/
ଯାଉଥଲେ	/d͡ʒaːut̪ʰɔle/
ଯାଉଥିବା	/d͡ʒaːut̪ʰibaː/
ଯାଉଥିଲା	/d͡ʒaːut̪ʰilaː/
ଯାଉଥିଲି	/d͡ʒaːut̪ʰili/
ଯାଉଥିଲେ	/d͡ʒaːut̪ʰile/
ଯାଉନଥିଲେ	/d͡ʒaːunɔt̪ʰile/
ଯାଉନି	/d͡ʒaːuni/
ଯାଉଯାଉ	/d͡ʒaːud͡ʒaːu/
ଯାଏ	/d͡ʒaːe/
ଯାଏଁ	/d͡ʒaːẽ/
ଯ଼ାଏଁ	/d͡ʒɔẽ/
ଯାକ	/d͡ʒaːkɔ/
ଯାଚିଲେ	/d͡ʒaːt͡ʃile/
ଯାଜପୁର	/d͡ʒaːd͡ʒɵpuɾɵ/
ଯାତ୍ରା	/d͡ʒaːt̪raː/
ଯାତ୍ରାରେ	/d͡ʒaːt̪raːre/
ଯାଦୁ	/d͡ʒaːd̪u/
ଯାନବାହନ	/d͡ʒaːnɔbaːhɔnɔ/
ଯାନ୍ତି	/d͡ʒaːnt̪i/
ଯାବୁଡ଼ି	/d͡ʒaːbuɽi/
ଯାହା	/d͡ʒaːhaː/
ଯାହାକି	/d͡ʒaːhaːki/
ଯାହାକୁ	/d͡ʒaːhaːku/
ଯାହାଙ୍କ	/d͡ʒaːhaːŋkɔ/
ଯାହାର	/d͡ʒaːhaːɾɵ/
ଯାହାହେଉ	/d͡ʒaːhaːheu/
ଯାହାହେଲେ	/d͡ʒaːhaːhele/
ଯିଏ	/d͡ʒie/
ଯିଏକି	/d͡ʒieki/
ଯିବ	/d͡ʒibɔ/
ଯିବା	/d͡ʒibaː/
ଯିବାକୁ	/d͡ʒibaːku/
ଯିବାବେଳେ	/d͡ʒibaːbel̪e/
ଯିବି	/d͡ʒibi/
ଯିବିନି	/d͡ʒibini/
ଯିବୁ	/d͡ʒibu/
ଯିବୁନି	/d͡ʒibuni/
ଯିବେ	/d͡ʒibe/
ଯୁକ୍ତ	/d͡ʒukt̪ɵ/
ଯୁକ୍ତରାଷ୍ଟ୍ର	/d͡ʒukt̪ɵraːsʈɾɵ/
ଯୁଗ	/d͡ʒuɡɵ/
ଯୁଗର	/d͡ʒuɡɵɾɵ/
ଯୁଗରେ	/d͡ʒuɡɵre/
ଯୁଦ୍ଧ	/d͡ʒud̪d̪ʱɵ/
ଯୁଦ୍ଧରେ	/d͡ʒud̪d̪ʱɔre/
ଯୁବ	/d͡ʒubɔ/
ଯୁବକ	/d͡ʒubɔkɔ/
ଯୁବକମାନେ	/d͡ʒubɔkɔmaːne/
ଯୁବକୁ	/d͡ʒubɔku/
ଯେ	/d͡ʒe/
ଯେଉଁ	/d͡ʒeũ/
ଯେଉଁଟା	/d͡ʒeũʈaː/
ଯେଉଁଠି	/d͡ʒeũʈʰi/
ଯେଉଁଥିରେ	/d͡ʒeũt̪ʰire/
ଯେଉଁମାନେ	/d͡ʒeũmaːne/
ଯେତେ	/d͡ʒet̪e/
ଯେତେଥର	/d͡ʒet̪et̪ʰɔɾɔ/
ଯେତେବେଳେ	/d͡ʒet̪ebel̪e/
ଯେପରି	/d͡ʒepɵri/
ଯେପରିକି	/d͡ʒepɵriki/
ଯେବେ	/d͡ʒebe/
ଯେଭଳି	/d͡ʒebʰɔl̪i/
ଯେମିତି	/d͡ʒemit̪i/
ଯେମିତିକି	/d͡ʒemit̪iki/
ଯେହେତୁ	/d͡ʒehet̪u/
ଯୋଗ	/d͡ʒoɡɵ/
ଯୋଗଦାନ	/d͡ʒoɡɵd̪aːnɵ/
ଯୋଗସୂତ୍ର	/d͡ʒoɡɵsut̪ɾɵ/
ଯୋଗାଡ଼	/d͡ʒogaːɽɔ/
ଯୋଗାଯୋଗ	/d͡ʒogaːd͡ʒoɡɵ/
ଯୋଗିନୀ	/d͡ʒogini/
ଯୋଗୁ	/d͡ʒogu/
ଯୋଗୁଁ	/d͡ʒogũ/
ଯୋଜନା	/d͡ʒod͡ʒɵnaː/
ଯୋଡି	/d͡ʒoɖi/
ଯୋଡ଼ି	/d͡ʒoɽi/
ଯୋଡ଼ିକ	/d͡ʒoɽikɔ/
ଯୋଡିବା	/d͡ʒoɖibaː/
ଯୋଡ଼ିବେ	/d͡ʒoɽibe/
ଯୋଡ଼େ	/d͡ʒoɽe/
ଯୋତାର	/d͡ʒot̪aːɾɔ/
ଯୋଦ୍ଧା	/d͡ʒod̪d̪ʱaː/
ଯୋଦ୍ଧାବାଇଙ୍କ	/d͡ʒod̪d̪ʱaːbaːiŋkɔ/
ଯୋଦ୍ଧାମାନଙ୍କର	/d͡ʒod̪d̪ʱaːmaːnɔŋkɔɾɔ/
ଯୋର	/d͡ʒoɾɔ/
ଯୋରରେ	/d͡ʒoɾɔre/
ଯୋଷ	/d͡ʒosɔ/
ୟା	/jaː/
ୟାକୁ	/jaːku/
ୟାଠୁ	/jaːʈʰu/
ୟିବା	/jibaː/
ୟୁ	/ju/
ୟେଲ୍ଲୁ	/jellu/
ରକମର	/ɾɔkɔmɔɾɔ/
ରକ୍ତ	/ɾɵkt̪ɵ/
ରକ୍ତକୁ	/ɾɔkt̪ɔku/
ରକ୍ତଚାପ	/ɾɵkt̪ɵt͡ʃaːpɵ/
ରକ୍ତରେ	/ɾɔkt̪ɔre/
ରକ୍ଷା	/ɾɵkʰjaː/
ରକ୍ଷାକର	/ɾɔkʰjaːkɔɾɔ/
ରଖ	/ɾɔkʰɔ/
ରଖନ୍ତି	/ɾɔkʰɔnt̪i/
ରଖା	/ɾɔkʰaː/
ରଖାଯାଇଛି	/ɾɔkʰaːd͡ʒaːit͡ʃʰi/
ରଖାଯାଇଥିବା	/ɾɔkʰaːd͡ʒaːit̪ʰibaː/
ରଖାଯାଇପାରିବ	/ɾɔkʰaːd͡ʒaːipaːribɔ/
ରଖାଯାଉଥିବା	/ɾɔkʰaːd͡ʒaːut̪ʰibaː/
ରଖାଯାଏ	/ɾɵkʰaːd͡ʒaːe/
ରଖାହୋଇଥିବା	/ɾɔkʰaːhoit̪ʰibaː/
ରଖି	/ɾɵkʰi/
ରଖିଗଲା	/ɾɔkʰiɡɔlaː/
ରଖିଛି	/ɾɔkʰit͡ʃʰi/
ରଖିଥିବା	/ɾɔkʰit̪ʰibaː/
ରଖିଥିଲା	/ɾɔkʰit̪ʰilaː/
ରଖିଦେଲେ	/ɾɔkʰid̪ele/
ରଖିପାରୁନଥିଲା	/ɾɔkʰipaːrunɔt̪ʰilaː/
ରଖିବା	/ɾɵkʰibaː/
ରଖିବାକୁ	/ɾɔkʰibaːku/
ରଖିବାରେ	/ɾɔkʰibaːre/
ରଖିବି	/ɾɔkʰibi/
ରଖିଲା	/ɾɔkʰilaː/
ରଖିଲେ	/ɾɔkʰile/
ରଖୁ	/ɾɔkʰu/
ରଖୁଛି	/ɾɔkʰut͡ʃʰi/
ରଖୁଥିବାବେଳେ	/ɾɔkʰut̪ʰibaːbel̪e/
ରଖୁଥିଲା	/ɾɔkʰut̪ʰilaː/
ରଂଗ	/ɾɔŋɡɔ/
ରଗଡ଼ୁ	/ɾɔɡɔɽu/
ରଂଗର	/ɾɔŋɡɔɾɔ/
ରଂଗୀନ	/ɾɔŋginɔ/
ରଗେଇବ	/ɾɔgeibɔ/
ରଘୁନାଥ	/ɾɵgʰunaːt̪ʰɵ/
ରଙ୍ଗ	/ɾɵŋɡɵ/
ରଙ୍ଗଣୀ	/ɾɔŋɡɔɳi/
ରଙ୍ଗମଞ୍ଚରେ	/ɾɔŋɡɔmɔɲt͡ʃɔre/
ରଙ୍ଗର	/ɾɵŋɡɵɾɵ/
ରଙ୍ଗୀନ	/ɾɔŋginɔ/
ରଙ୍ଗୀନ୍‌	/ɾɔŋgin/
ରଙ୍ଗୋଲି	/ɾɔŋgoli/
ରଚନା	/ɾɵt͡ʃɵnaː/
ରଚନାବଳୀ	/ɾɵt͡ʃɵnaːbɵl̪i/
ରଚିତ	/ɾɵt͡ʃit̪ɵ/
ରଜ	/ɾɵd͡ʒɵ/
ରଜନୀ	/ɾɔd͡ʒɔni/
ରଞ୍ଜନ	/ɾɵɲd͡ʒɵnɵ/
ରଡ଼ି	/ɾɔɽi/
ରଡିଛାଡିଲା	/ɾɔɖit͡ʃʰaːɖilaː/
ରଡ୍	/ɾɔɖ/
ରତ୍ନ	/ɾɵt̪nɵ/
ରଥ	/ɾɵt̪ʰɵ/
ରଥଯାତ୍ରା	/ɾɵt̪ʰɵd͡ʒaːt̪raː/
ରଥରେ	/ɾɵt̪ʰɵre/
ରନ୍ଧା	/ɾɔnd̪ʱaː/
ରନ୍ଧାଘର	/ɾɔnd̪ʱaːɡʱɔɾɔ/
ରନ୍ଧାଘରେ	/ɾɔnd̪ʱaːɡʱɔre/
ରନ୍ଧାଣିଆ	/ɾɔnd̪ʱaːɳiaː/
ରନ୍ଧାଶାଳ	/ɾɔnd̪ʱaːsaːl̪ɔ/
ରନ୍ଧାଶାଳରୁ	/ɾɔnd̪ʱaːsaːl̪ɔru/
ରଫୁ	/ɾɔpʰu/
ରବର	/ɾɔbɔɾɔ/
ରବି	/ɾɵbi/
ରବିବାର	/ɾɵbibaːɾɵ/
ରରେ	/ɾɔre/
ରଷୋଇ	/ɾɔsoi/
ରସ	/ɾɵsɵ/
ରସର	/ɾɔsɔɾɔ/
ରସାୟନ	/ɾɵsaːjɵnɵ/
ରସାୟନିକ	/ɾɔsaːjɔnikɔ/
ରସାଳ	/ɾɔsaːl̪ɔ/
ରସୁଣ	/ɾɔsuɳɔ/
ରହ	/ɾɔhɔ/
ରହମତ	/ɾɔhɔmɔt̪ɔ/
ରହମତ୍	/ɾɔhɔmɔt̪/
ରହି	/ɾɵhi/
ରହିଅଛି	/ɾɵhiɵt͡ʃʰi/
ରହିଗଲା	/ɾɔhiɡɔlaː/
ରହିଗଲି	/ɾɔhiɡɔli/
ରହିଛି	/ɾɵhit͡ʃʰi/
ରହିଥାଏ	/ɾɵhit̪ʰaːe/
ରହିଥିବା	/ɾɵhit̪ʰibaː/
ରହିଥିଲା	/ɾɵhit̪ʰilaː/
ରହିଥିଲେ	/ɾɵhit̪ʰile/
ରହିପାରିବ	/ɾɔhipaːribɔ/
ରହିପାରିବିନି	/ɾɔhipaːribini/
ରହିବ	/ɾɵhibɵ/
ରହିବା	/ɾɵhibaː/
ରହିବାକୁ	/ɾɔhibaːku/
ରହିବୁ	/ɾɔhibu/
ରହିଲା	/ɾɵhilaː/
ରହିଲେ	/ɾɵhile/
ରହୁ	/ɾɔhu/
ରହୁଥଲା	/ɾɔhut̪ʰɔlaː/
ରହୁଥିବା	/ɾɵhut̪ʰibaː/
ରହୁଥିଲା	/ɾɔhut̪ʰilaː/
ରହୁଥିଲେ	/ɾɔhut̪ʰile/
ରହେ	/ɾɵhe/
ରାଉତ	/raːut̪ɵ/
ରାଉତରାୟ	/raːut̪ɵraːjɵ/
ରାଉରକେଲା	/raːuɾɵkelaː/
ରାଓ	/raːo/
ରାକ୍ଷସ	/raːkʰjɔsɔ/
ରାଗ	/raːɡɔ/
ରାଗି	/raːgi/
ରାଗିକି	/raːgiki/
ରାଗିଛନ୍ତି	/raːgit͡ʃʰɔnt̪i/
ରାଗିଛି	/raːgit͡ʃʰi/
ରାଗିନି	/raːgini/
ରାଗିଯାଇ	/raːgid͡ʒaːi/
ରାଜ	/raːd͡ʒɵ/
ରାଜକୀୟ	/raːd͡ʒɔkijɔ/
ରାଜକୁମାରୀ	/raːd͡ʒɔkumaːri/
ରାଜଦରବାର	/raːd͡ʒɔd̪ɔɾɔbaːɾɔ/
ରାଜଦରବାରକୁ	/raːd͡ʒɔd̪ɔɾɔbaːɾɔku/
ରାଜଧାନୀ	/raːd͡ʒɵd̪ʱaːni/
ରାଜନୀତି	/raːd͡ʒɵnit̪i/
ରାଜନୈତିକ	/raːd͡ʒɵnɵit̪ikɵ/
ରାଜପୁତ	/raːd͡ʒɔput̪ɔ/
ରାଜପୁତମାନେ	/raːd͡ʒɔput̪ɔmaːne/
ରାଜପୁତ୍	/raːd͡ʒɔput̪/
ରାଜପ୍ରାସାଦ	/raːd͡ʒɔpraːsaːd̪ɔ/
ରାଜବଂଶର	/raːd͡ʒɔbɔŋsɔɾɔ/
ରାଜସ୍ଥାନ	/raːd͡ʒɵst̪ʰaːnɵ/
ରାଜା	/raːd͡ʒaː/
ରାଜାଂକ	/raːd͡ʒaːŋkɔ/
ରାଜାକୁ	/raːd͡ʒaːku/
ରାଜାଙ୍କ	/raːd͡ʒaːŋkɵ/
ରାଜାଙ୍କୁ	/raːd͡ʒaːŋku/
ରାଜାର	/raːd͡ʒaːɾɔ/
ରାଜି	/raːd͡ʒi/
ରାଜିହେଲେ	/raːd͡ʒihele/
ରାଜୁ	/raːd͡ʒu/
ରାଜେନ୍ଦ୍ର	/raːd͡ʒend̪ɾɵ/
ରାଜ୍ୟ	/raːd͡ʒjɵ/
ରାଜ୍ୟପାଳ	/raːd͡ʒjɵpaːl̪ɵ/
ରାଜ୍ୟର	/raːd͡ʒjɵɾɵ/
ରାଜ୍ୟରେ	/raːd͡ʒjɵre/
ରାଣ	/raːɳɔ/
ରାଣୀ	/raːɳi/
ରାତି	/raːt̪i/
ରାତିଟିରେ	/raːt̪iʈire/
ରାତିର	/raːt̪iɾɔ/
ରାତିରେ	/raːt̪ire/
ରାତ୍ରୀ	/raːt̪ri/
ରାଧା	/raːd̪ʱaː/
ରାଧାନାଥ	/raːd̪ʱaːnaːt̪ʰɵ/
ରାନ୍ଧ	/raːnd̪ʱɔ/
ରାନ୍ଧଣା	/raːnd̪ʱɵɳaː/
ରାନ୍ଧି	/raːnd̪ʱi/
ରାନ୍ଧିବା	/raːnd̪ʱibaː/
ରାନ୍ଧିବାକୁ	/raːnd̪ʱibaːku/
ରାନ୍ଧିବାରେ	/raːnd̪ʱibaːre/
ରାନ୍ଧିଲା	/raːnd̪ʱilaː/
ରାନ୍ଧିହେବ	/raːnd̪ʱihebɔ/
ରାନ୍ଧୁଛି	/raːnd̪ʱut͡ʃʰi/
ରାନ୍ଧୁଥିବା	/raːnd̪ʱut̪ʰibaː/
ରାବିଲା	/raːbilaː/
ରାବୁଥିଲେ	/raːbut̪ʰile/
ରାମ	/raːmɵ/
ରାମକୃଷ୍ଣ	/raːmɵkrusɳɵ/
ରାମଚନ୍ଦ୍ର	/raːmɵt͡ʃɵnd̪ɾɵ/
ରାମାୟଣ	/raːmaːjɵɳɵ/
ରାମୁ	/raːmu/
ରାୟ	/raːjɵ/
ରାୟଗଡ଼ା	/raːjɵɡɵɽaː/
ରାଶି	/raːsi/
ରାଶିଗୁଡ଼	/raːsiguɽɔ/
ରାଷ୍ଟ୍ର	/raːsʈɾɵ/
ରାଷ୍ଟ୍ରପତି	/raːsʈɾɵpɵt̪i/
ରାଷ୍ଟ୍ରୀୟ	/raːsʈrijɵ/
ରାସାୟନ	/raːsaːjɔnɔ/
ରାସାୟନିକ	/raːsaːjɵnikɵ/
ରାସ୍ତା	/raːst̪aː/
ରାସ୍ତାଟିଏ	/raːst̪aːʈie/
ରାସ୍ତାର	/raːst̪aːɾɔ/
ରାସ୍ତାରେ	/raːst̪aːre/
ରାସ୍ଥାରେ	/raːst̪ʰaːre/
ରିପୋର୍ଟ	/riporʈɔ/
ରୁ	/ru/
ରୁଟି	/ruʈi/
ରୁଟିକି	/ruʈiki/
ରୁଟିକୁ	/ruʈiku/
ରୁଟିଟି	/ruʈiʈi/
ରୁପା	/rupaː/
ରୁପେ	/rupe/
ରୁପେଲି	/rupeli/
ରୁମ୍	/rum/
ରୁହ	/ruhɔ/
ରୁହେ	/ruhe/
ରୂପ	/rupɵ/
ରୂପରେ	/rupɵre/
ରୂପେ	/rupe/
ରେ	/re/
ରେଖାରେ	/rekʰaːre/
ରେଣୁ	/reɳu/
ରେଭେନ୍ସା	/rebʱensaː/
ରେଳ	/rel̪ɵ/
ରେଶମ	/resɔmɔ/
ରେଶମରେ	/resɔmɔre/
ରୋଇବାରେ	/roibaːre/
ରୋଗ	/roɡɵ/
ରୋଗର	/roɡɵɾɵ/
ରୋଗରେ	/roɡɵre/
ରୋଗାନ୍	/rogaːn/
ରୋଗୀ	/rogi/
ରୋଟି	/roʈi/
ରୋଡ଼	/roɖɵ/
ରୋବଟ୍‌	/robɵʈ/
ରୋମ	/romɔ/
ରୋମାଞ୍ଚକ	/romaːɲt͡ʃɔkɔ/
ରୋଷେଇ	/rosei/
ରୋହନ	/rohɔnɔ/
ଲକ୍ଷ	/lɵkʰjɵ/
ଲକ୍ଷଣ	/lɵkʰjɵɳɵ/
ଲକ୍ଷ୍ମଣ	/lɵkʰmɵɳɵ/
ଲକ୍ଷ୍ମୀ	/lɵkʰmi/
ଲକ୍ଷ୍ୟ	/lɵkʰjɵ/
ଲଗାଇ	/lɔgaːi/
ଲଗାଇଛ	/lɔgaːit͡ʃʰɔ/
ଲଗାଇଥାନ୍ତି	/lɔgaːit̪ʰaːnt̪i/
ଲଗାଇଥିବା	/lɔgaːit̪ʰibaː/
ଲଗାଉଥିଲା	/lɔgaːut̪ʰilaː/
ଲଗାଉଥିଲେ	/lɔgaːut̪ʰile/
ଲଗାନ୍ତି	/lɔgaːnt̪i/
ଲଗେଇବାକୁ	/lɔgeibaːku/
ଲଗେଇଲା	/lɔgeilaː/
ଲଙ୍କା	/lɵŋkaː/
ଲଡୁ	/lɔɖu/
ଲଡୁଟିଏ	/lɔɖuʈie/
ଲଡୁର	/lɔɖuɾɔ/
ଲଡ୍ଡୁ	/lɔɖɖu/
ଲଢିବ	/lɔɖʱibɔ/
ଲଢ଼ୁଛୁ	/lɔɽʱut͡ʃʰu/
ଲଣ୍ଠନ	/lɔɳʈʰɔnɔ/
ଲତା	/lɵt̪aː/
ଲବଙ୍ଗ	/lɔbɔŋɡɔ/
ଲମ୍ବ	/lɵmbɵ/
ଲମ୍ବା	/lɵmbaː/
ଲମ୍ବାମାଛ	/lɔmbaːmaːt͡ʃʰɔ/
ଲମ୍ୱା	/lɔmuaː/
ଲମ୍ୱାବାଳ	/lɔmuaːbaːl̪ɔ/
ଲମ୍ୱୁ	/lɔmu/
ଲଳିତା	/lɔl̪it̪aː/
ଲସ୍ସି	/lɔssi/
ଲହରେଇ	/lɔhɔrei/
ଲା	/laː/
ଲାଇଟ	/laːiʈɔ/
ଲାଇଟ୍	/laːiʈ/
ଲାଇନ୍	/laːin/
ଲାଗନ୍ତି	/laːɡɔnt̪i/
ଲାଗି	/laːgi/
ଲାଗିଛି	/laːgit͡ʃʰi/
ଲାଗିଥିବା	/laːgit̪ʰibaː/
ଲାଗିପାରେ	/laːgipaːre/
ଲାଗିବ	/laːgibɔ/
ଲାଗିବା	/laːgibaː/
ଲାଗିଯାଅ	/laːgid͡ʒaːɔ/
ଲାଗିଯାଇଛି	/laːgid͡ʒaːit͡ʃʰi/
ଲାଗିଯାଏ	/laːgid͡ʒaːe/
ଲାଗିଯାନ୍ତି	/laːgid͡ʒaːnt̪i/
ଲାଗିଯିବ	/laːgid͡ʒibɔ/
ଲାଗିଲା	/laːgilaː/
ଲାଗିଲାଣି	/laːgilaːɳi/
ଲାଗିଲାନି	/laːgilaːni/
ଲାଗିଲେ	/laːgile/
ଲାଗିଲେଣି	/laːgileɳi/
ଲାଗୁଛି	/laːgut͡ʃʰi/
ଲାଗୁଥାଏ	/laːgut̪ʰaːe/
ଲାଗୁଥିଲା	/laːgut̪ʰilaː/
ଲାଗୁଥିଲେ	/laːgut̪ʰile/
ଲାଗୁନି	/laːguni/
ଲାଗେ	/laːge/
ଲାଗେନି	/laːgeni/
ଲାଙ୍ଗଲେନ	/laːŋɡɔlenɔ/
ଲାଙ୍ଗଲେନର	/laːŋɡɔlenɔɾɔ/
ଲାଜ	/laːd͡ʒɔ/
ଲାଂଜ	/laːŋd͡ʒɔ/
ଲାଂଜକୁ	/laːŋd͡ʒɔku/
ଲାଜୁଆ	/laːd͡ʒuaː/
ଲାଞ	/laːɲɔ/
ଲାଞକୁ	/laːɲɔku/
ଲାଞ୍ଜ	/laːɲd͡ʒɔ/
ଲାଞ୍ଜକୁ	/laːɲd͡ʒɔku/
ଲାଭ	/laːbʰɵ/
ଲାଭଦାୟକ	/laːbʰɔd̪aːjɔkɔ/
ଲାର୍ଭା	/laːrbʱaː/
ଲାଲ	/laːlɵ/
ଲାଲରଙ୍ଗ	/laːlɔɾɔŋɡɔ/
ଲାଲରଙ୍ଗର	/laːlɔɾɔŋɡɔɾɔ/
ଲାଲା	/laːlaː/
ଲାଲ୍	/laːl/
ଲାଲ୍‌	/laːl/
ଲିଖନ	/likʰɵnɵ/
ଲିଖିତ	/likʰit̪ɵ/
ଲିଙ୍କ	/liŋkɵ/
ଲିଙ୍ଗରାଜ	/liŋɡɵraːd͡ʒɵ/
ଲିନକ୍ସ	/linɵksɵ/
ଲିପି	/lipi/
ଲିଫ୍‌ଟରେ	/lipʰʈɔre/
ଲିଭାଇ	/libʱaːi/
ଲିଭେ	/libʱe/
ଲୀଳା	/lil̪aː/
ଲୁଗା	/lugaː/
ଲୁଗାଧୁଆ	/lugaːd̪ʱuaː/
ଲୁଚାଇ	/lut͡ʃaːi/
ଲୁଚି	/lut͡ʃi/
ଲୁଚିଗଲା	/lut͡ʃiɡɔlaː/
ଲୁଚିଯାଅ	/lut͡ʃid͡ʒaːɔ/
ଲୁଣ	/luɳɵ/
ଲୁଣିଆ	/luɳiaː/
ଲୁସିଅସ୍	/lusiɔs/
ଲୁସିଫେରାସ୍	/lusipʰeraːs/
ଲୁସିଫେରିନ	/lusipʰerinɔ/
ଲୁହ	/luhɔ/
ଲୁହଦାଗ	/luhɔd̪aːɡɔ/
ଲୁହା	/luhaː/
ଲୁହାର	/luhaːɾɔ/
ଲୁହାରେ	/luhaːre/
ଲେଉଟାଣି	/leuʈaːɳi/
ଲେଖ	/lekʰɔ/
ଲେଖକ	/lekʰɵkɵ/
ଲେଖନ୍ତୁ	/lekʰɵnt̪u/
ଲେଖା	/lekʰaː/
ଲେଖାଏଁ	/lekʰaːẽ/
ଲେଖାଗଲା	/lekʰaːɡɵlaː/
ଲେଖାର	/lekʰaːɾɵ/
ଲେଖାରେ	/lekʰaːre/
ଲେଖି	/lekʰi/
ଲେଖିଥିଲେ	/lekʰit̪ʰile/
ଲେଖିବା	/lekʰibaː/
ଲେଖିଲେ	/lekʰile/
ଲେଖୁନ	/lekʰunɔ/
ଲେଣି	/leɳi/
ଲେମ୍ବୁ	/lembu/
ଲେମ୍ବୁସର୍ବତ	/lembusɔrbɔt̪ɔ/
ଲେମ୍ୱୁ	/lemu/
ଲୋ	/lo/
ଲୋକ	/lokɵ/
ଲୋକକଳା	/lokɵkɵl̪aː/
ଲୋକକୁ	/lokɔku/
ଲୋକଙ୍କ	/lokɵŋkɵ/
ଲୋକଙ୍କର	/lokɵŋkɵɾɵ/
ଲୋକଙ୍କୁ	/lokɵŋku/
ଲୋକଜଣଂକ	/lokɔd͡ʒɔɳɔŋkɔ/
ଲୋକଟି	/lokɔʈi/
ଲୋକପ୍ରିୟ	/lokɵprijɵ/
ଲୋକମାନଙ୍କୁ	/lokɔmaːnɔŋku/
ଲୋକମାନେ	/lokɵmaːne/
ଲୋକର	/lokɔɾɔ/
ଲୋକସଂଖ୍ୟା	/lokɵsɵŋkʰjaː/
ଲୋକସଭା	/lokɵsɵbʱaː/
ଲୋକେ	/loke/
ଲୋଗୋ	/logo/
ଲୋଦିଙ୍କୁ	/lod̪iŋku/
ଲୋଭ	/lobʰɔ/
ଲୋହିତ	/lohit̪ɵ/
ୱର୍ଷା	/uɔrsaː/
ୱସନ୍ତ	/uɔsɔnt̪ɔ/
ୱାଡା	/uaːɖaː/
ଶଂକର	/sɔŋkɔɾɔ/
ଶଂକରର	/sɔŋkɔɾɔɾɔ/
ଶକ୍ତ	/sɔkt̪ɔ/
ଶକ୍ତି	/sɵkt̪i/
ଶକ୍ତିପୀଠ	/sɵkt̪ipiʈʰɵ/
ଶଙ୍କର	/sɵŋkɵɾɵ/
ଶଙ୍ଖ	/sɵŋkʰɵ/
ଶତକଡ଼ା	/sɵt̪ɵkɵɽaː/
ଶତପଥୀ	/sɵt̪ɵpɵt̪ʰi/
ଶତାବ୍ଦୀ	/sɵt̪aːbd̪i/
ଶତାବ୍ଦୀର	/sɵt̪aːbd̪iɾɵ/
ଶତାବ୍ଦୀରେ	/sɵt̪aːbd̪ire/
ଶନିବାର	/sɵnibaːɾɵ/
ଶବୁଜ	/sɔbud͡ʒɔ/
ଶବ୍ଦ	/sɵbd̪ɵ/
ଶବ୍ଦକୁ	/sɔbd̪ɔku/
ଶବ୍ଦର	/sɵbd̪ɵɾɵ/
ଶୟନଗୃହ	/sɔjɔnɔgruhɔ/
ଶରତ	/sɵɾɵt̪ɵ/
ଶରୀର	/sɵriɾɵ/
ଶରୀରର	/sɵriɾɵɾɵ/
ଶରୀରରେ	/sɵriɾɵre/
ଶସ୍ୟ	/sɔsjɔ/
ଶହ	/sɔhɔ/
ଶହରର	/sɔhɔɾɔɾɔ/
ଶହେ	/sɔhe/
ଶାକାହାରୀ	/saːkaːhaːri/
ଶାଖା	/saːkʰaː/
ଶାଗ	/saːɡɵ/
ଶାଗୁଆ	/saːguaː/
ଶାଢ଼ୀ	/saːɽʱi/
ଶାନ୍ତ	/saːnt̪ɔ/
ଶାନ୍ତଥିଲା	/saːnt̪ɔt̪ʰilaː/
ଶାନ୍ତି	/saːnt̪i/
ଶାନ୍ତିରେ	/saːnt̪ire/
ଶାରଳା	/saːɾɵl̪aː/
ଶାରୀରିକ	/saːririkɵ/
ଶାସନ	/saːsɵnɵ/
ଶାସନକାଳ	/saːsɔnɔkaːl̪ɔ/
ଶାସ୍ତ୍ର	/saːst̪ɾɵ/
ଶାସ୍ତ୍ରିୟ	/saːst̪rijɔ/
ଶାସ୍ତ୍ରୀୟ	/saːst̪rijɵ/
ଶାହୀ	/saːhi/
ଶିକାରୀ	/sikaːri/
ଶିକ୍ଷକ	/sikʰjɵkɵ/
ଶିକ୍ଷକଙ୍କ	/sikʰjɔkɔŋkɔ/
ଶିକ୍ଷଣ	/sikʰjɵɳɵ/
ଶିକ୍ଷା	/sikʰjaː/
ଶିକ୍ଷିତା	/sikʰit̪aː/
ଶିଖ	/sikʰɔ/
ଶିଖାଇ	/sikʰaːi/
ଶିଖାଇଦେବେ	/sikʰaːid̪ebe/
ଶିଖାଇଦେଲେ	/sikʰaːid̪ele/
ଶିଖାଇବ	/sikʰaːibɔ/
ଶିଖିଗଲି	/sikʰiɡɔli/
ଶିଖିଥିଲା	/sikʰit̪ʰilaː/
ଶିଖିବା	/sikʰibaː/
ଶିଖିବାକୁ	/sikʰibaːku/
ଶିଖିବୁ	/sikʰibu/
ଶିଖିଯାଅ	/sikʰid͡ʒaːɔ/
ଶିଖିଯିବ	/sikʰid͡ʒibɔ/
ଶିଖୁଛି	/sikʰut͡ʃʰi/
ଶିଖୁଥିଲା	/sikʰut̪ʰilaː/
ଶିଖୁଥିଲେ	/sikʰut̪ʰile/
ଶିଘ୍ର	/sigʰɾɔ/
ଶିଡ଼ି	/siɽi/
ଶିଡ଼ି-ଚଢ଼ା	/siɽi-t͡ʃɔɽʱaː/
ଶିଡ଼ିରେ	/siɽire/
ଶିତିକଣ୍ଠ	/sit̪ikɵɳʈʰɵ/
ଶିଥିଳ	/sit̪ʰil̪ɔ/
ଶିବ	/sibɵ/
ଶିବମନ୍ଦିର	/sibɵmɵnd̪iɾɵ/
ଶିବରାତ୍ରି	/sibɵraːt̪ri/
ଶିମଲା	/simɔlaː/
ଶିମଳା	/simɔl̪aː/
ଶିମିଳି	/simil̪i/
ଶିଳ୍ପ	/sil̪pɵ/
ଶିଶିର	/sisiɾɔ/
ଶିଶୁ	/sisu/
ଶୀଘ୍ର	/sigʰɾɵ/
ଶୀତ	/sit̪ɔ/
ଶୀତଦିନ	/sit̪ɔd̪inɔ/
ଶୀତଦିନେ	/sit̪ɔd̪ine/
ଶୀତରୁ	/sit̪ɔru/
ଶୀତରେ	/sit̪ɔre/
ଶୀତଳ	/sit̪ɵl̪ɵ/
ଶୀତୁଆ	/sit̪uaː/
ଶୀତୋଷ୍ଣ	/sit̪osɳɔ/
ଶୁଆ	/suaː/
ଶୁଆଟିଏ	/suaːʈie/
ଶୁକ୍ଳ	/sukl̪ɵ/
ଶୁକ୍ଳପକ୍ଷ	/sukl̪ɵpɵkʰjɵ/
ଶୁଖି	/sukʰi/
ଶୁଖିଲା	/sukʰilaː/
ଶୁଖେଇବାକୁ	/sukʰeibaːku/
ଶୁଂଘି	/suŋgʰi/
ଶୁଂଘିଦେଲା	/suŋgʰid̪elaː/
ଶୁଙ୍ଘିବାକୁ	/suŋgʰibaːku/
ଶୁଣ	/suɳɔ/
ଶୁଣା	/suɳaː/
ଶୁଣାଇଥାନ୍ତି	/suɳaːit̪ʰaːnt̪i/
ଶୁଣାଇଲେ	/suɳaːile/
ଶୁଣାନ୍ତି	/suɳaːnt̪i/
ଶୁଣି	/suɳi/
ଶୁଣିପାର	/suɳipaːɾɔ/
ଶୁଣିପାରିବି	/suɳipaːribi/
ଶୁଣିପାରିଲେ	/suɳipaːrile/
ଶୁଣିପାରେ	/suɳipaːre/
ଶୁଣିବ	/suɳibɔ/
ଶୁଣିବାକୁ	/suɳibaːku/
ଶୁଣିଲଣି	/suɳilɔɳi/
ଶୁଣିଲା	/suɳilaː/
ଶୁଣିଲେ	/suɳile/
ଶୁଣେନି	/suɳeni/
ଶୁଣ୍ତକୁ	/suɳt̪ɔku/
ଶୁଭ	/subʰɵ/
ଶୁଭଂକର	/subʰɔŋkɔɾɔ/
ଶୁଭା	/subʱaː/
ଶୁଭିଲା	/subʱilaː/
ଶୁଭୁଥିଲା	/subʱut̪ʰilaː/
ଶୂଚନା	/sut͡ʃɔnaː/
ଶେଖର	/sekʰɵɾɵ/
ଶେଷ	/sesɵ/
ଶେଷକୁ	/sesɔku/
ଶେଷମୁଣ୍ଡଟି	/sesɔmuɳɖɔʈi/
ଶେଷରେ	/sesɵre/
ଶୈନାବୀ	/sɔinaːbi/
ଶୈଳୀ	/sɵil̪i/
ଶୈଳୀରେ	/sɵil̪ire/
ଶୋଇ	/soi/
ଶୋଇକି	/soiki/
ଶୋଇଛନ୍ତି	/soit͡ʃʰɔnt̪i/
ଶୋଇଥାନ୍ତି	/soit̪ʰaːnt̪i/
ଶୋଇନି	/soini/
ଶୋଇପଡ଼ିଲା	/soipɔɽilaː/
ଶୋଇବା	/soibaː/
ଶୋଇଲି	/soili/
ଶୋଭାଯାତ୍ରାରେ	/sobʱaːd͡ʒaːt̪raːre/
ଶୋଷ	/sosɔ/
ଶୋଷିବା	/sosibaː/
ଶୋଷିବାକୁ	/sosibaːku/
ଶୌକିନିଆ	/sɔukiniaː/
ଶ୍ରାଦ୍ଧ	/sraːd̪d̪ʱɵ/
ଶ୍ରାବଣ	/sraːbɵɳɵ/
ଶ୍ରୀ	/sri/
ଶ୍ରୀକୃଷ୍ଣ	/srikrusɳɵ/
ଶ୍ରୀଙ୍ଗେରୀ	/sriŋgeri/
ଶ୍ରୀଜଗନ୍ନାଥ	/srid͡ʒɵɡɵnnaːt̪ʰɵ/
ଶ୍ରୀନଗର	/srinɔɡɔɾɔ/
ଶ୍ରୀନିବାସ	/srinibaːsɔ/
ଶ୍ରୀନିବାସକୁ	/srinibaːsɔku/
ଶ୍ରୀନିବାସର	/srinibaːsɔɾɔ/
ଶ୍ରୀମନ୍ଦିର	/srimɵnd̪iɾɵ/
ଶ୍ରୀମନ୍ଦିରରେ	/srimɵnd̪iɾɵre/
ଶ୍ରୀରାମ	/sriraːmɵ/
ଶ୍ରୀଲଙ୍କା	/srilɵŋkaː/
ଶ୍ରେଣୀ	/sreɳi/
ଶ୍ରେଣୀକକ୍ଷ	/sreɳikɔkʰjɔ/
ଶ୍ରେଣୀକୁ	/sreɳiku/
ଶ୍ରେଣୀରେ	/sreɳire/
ଶ୍ରେଷ୍ଠ	/sresʈʰɵ/
ଶ୍ଵାସ	/suaːsɵ/
ଶ୍ୱାସ	/suaːsɔ/
ଷଟକୋଣ	/sɔʈɔkoɳɔ/
ଷଷ୍ଠ	/sɵsʈʰɵ/
ଷଷ୍ଠୀ	/sɵsʈʰi/
ଷୀର	/siɾɔ/
ଷ୍ଟୁଲ୍	/sʈul/
ସ-ସ-ସ	/sɔ-sɔ-sɔ/
ସଉକିଆ	/sɔukiaː/
ସଉଦା	/sɔud̪aː/
ସକ	/sɔkɔ/
ସକାଳ	/sɵkaːl̪ɵ/
ସକାଳୁ	/sɔkaːl̪u/
ସକାଳେ	/sɔkaːl̪e/
ସକାଶେ	/sɔkaːse/
ସକାସେ	/sɔkaːse/
ସଂକ୍ରମଣ	/sɵŋkɾɵmɵɳɵ/
ସଂକ୍ରମିତ	/sɵŋkɾɵmit̪ɵ/
ସଂକ୍ରାନ୍ତି	/sɵŋkraːnt̪i/
ସକ୍ରିୟ	/sɵkrijɵ/
ସଂକ୍ଷିପ୍ତ	/sɵŋkʰipt̪ɵ/
ସଂଖ୍ୟା	/sɵŋkʰjaː/
ସଂଖ୍ୟା-ଗଣତି	/sɔŋkʰjaː-ɡɔɳɔt̪i/
ସଂଖ୍ୟାମାନଂକ	/sɔŋkʰjaːmaːnɔŋkɔ/
ସଂଖ୍ୟାମାନେ	/sɔŋkʰjaːmaːne/
ସଂଖ୍ୟାମାଳା	/sɔŋkʰjaːmaːl̪aː/
ସଂଗଠନ	/sɵŋɡɵʈʰɵnɵ/
ସଂଗମ	/sɔŋɡɔmɔ/
ସଂଗରେ	/sɔŋɡɔre/
ସଂଗୀତ	/sɵŋgit̪ɵ/
ସଂଗୃହିତ	/sɔŋgruhit̪ɔ/
ସଂଗ୍ରହ	/sɵŋgɾɵhɵ/
ସଂଗ୍ରହାଳୟ	/sɵŋgɾɵhaːl̪ɵjɵ/
ସଂଗ୍ରାମ	/sɵŋgraːmɵ/
ସଂଗ୍ରାମୀ	/sɵŋgraːmi/
ସଂଘ	/sɵŋɡʱɵ/
ସଙ୍କଳନ	/sɵŋkɵl̪ɵnɵ/
ସଙ୍କେତ	/sɔŋket̪ɔ/
ସଙ୍ଗଠନ	/sɵŋɡɵʈʰɵnɵ/
ସଙ୍ଗରେ	/sɔŋɡɔre/
ସଙ୍ଗାତ	/sɔŋgaːt̪ɔ/
ସଙ୍ଗୀତ	/sɵŋgit̪ɵ/
ସଙ୍ଗୀତକାର	/sɵŋgit̪ɵkaːɾɵ/
ସଙ୍ଗେ	/sɵŋge/
ସଙ୍ଘ	/sɵŋɡʱɵ/
ସଜ	/sɔd͡ʒɔ/
ସଜା	/sɔd͡ʒaː/
ସଜାଇ	/sɔd͡ʒaːi/
ସଜାଇବା	/sɔd͡ʒaːibaː/
ସଜାଣି	/sɵd͡ʒaːɳi/
ସଜୀବ	/sɔd͡ʒibɔ/
ସଜେଇଛି	/sɔd͡ʒeit͡ʃʰi/
ସଜ୍ଜିତ	/sɔd͡ʒd͡ʒit̪ɔ/
ସଞ୍ଚୟ	/sɔɲt͡ʃɔjɔ/
ସଞ୍ଚାରିତ	/sɔɲt͡ʃaːrit̪ɔ/
ସଞ୍ଜୟ	/sɵɲd͡ʒɵjɵ/
ସଞ୍ଜରେ	/sɔɲd͡ʒɔre/
ସଠିକ	/sɵʈʰikɵ/
ସତ	/sɔt̪ɔ/
ସତର	/sɔt̪ɔɾɔ/
ସତରେ	/sɔt̪ɔre/
ସତର୍କ	/sɔt̪ɔrkɔ/
ସତେ	/sɔt̪e/
ସତେଜ	/sɔt̪ed͡ʒɔ/
ସତ୍ୟ	/sɵt̪jɵ/
ସତ୍ଵ	/sɵt̪uɵ/
ସଦର	/sɵd̪ɵɾɵ/
ସଦସ୍ୟ	/sɵd̪ɵsjɵ/
ସନ୍ତସନ୍ତିଆ	/sɔnt̪ɔsɔnt̪iaː/
ସନ୍ତାନ	/sɵnt̪aːnɵ/
ସନ୍ତାନକୁ	/sɔnt̪aːnɔku/
ସନ୍ତୁଷ୍ଟ	/sɵnt̪usʈɵ/
ସନ୍ଧିରେ	/sɔnd̪ʱire/
ସନ୍ଧ୍ୟା	/sɵnd̪ʱjaː/
ସନ୍ଧ୍ୟାରେ	/sɔnd̪ʱjaːre/
ସଂପୂର୍ଣ୍ଣ	/sɵŋpurɳɳɵ/
ସପ୍ତମୀ	/sɵpt̪ɵmi/
ସପ୍ତାହ	/sɵpt̪aːhɵ/
ସପ୍ତାହର	/sɵpt̪aːhɵɾɵ/
ସପ୍ତାହରେ	/sɔpt̪aːhɔre/
ସପ୍ତାହେ	/sɔpt̪aːhe/
ସଫଳ	/sɵpʰɵl̪ɵ/
ସଫଳତା	/sɵpʰɵl̪ɵt̪aː/
ସଫା	/sɔpʰaː/
ସଫାକରିବା	/sɔpʰaːkɔribaː/
ସଫାକଲା	/sɔpʰaːkɔlaː/
ସଫ୍ଟୱେର	/sɵpʰʈɵueɾɵ/
ସବା	/sɔbaː/
ସବାଶେଷ	/sɔbaːsesɔ/
ସବୁ	/sɵbu/
ସବୁଆଡ଼କୁ	/sɔbuaːɽɔku/
ସବୁକିଛି	/sɔbukit͡ʃʰi/
ସବୁକୁ	/sɵbuku/
ସବୁଗୁଡ଼ିକ	/sɔbuguɽikɔ/
ସବୁଜ	/sɵbud͡ʒɵ/
ସବୁଜରଙ୍ଗର	/sɔbud͡ʒɔɾɔŋɡɔɾɔ/
ସବୁଠାରୁ	/sɵbuʈʰaːru/
ସବୁଠି	/sɔbuʈʰi/
ସବୁଠୁଁ	/sɔbuʈʰũ/
ସବୁଠୁ	/sɵbuʈʰu/
ସବୁତକ	/sɔbut̪ɔkɔ/
ସବୁଥର	/sɔbut̪ʰɔɾɔ/
ସବୁଦିଗକୁ	/sɔbud̪iɡɔku/
ସବୁଦିନ	/sɔbud̪inɔ/
ସବୁପିଲାଙ୍କ	/sɔbupilaːŋkɔ/
ସବୁବେଳେ	/sɔbubel̪e/
ସବ୍ୟସାଚୀ	/sɵbjɵsaːt͡ʃi/
ସଭା	/sɵbʱaː/
ସଭାପତି	/sɵbʱaːpɵt̪i/
ସଭ୍ୟ	/sɵbʱjɵ/
ସମଗ୍ର	/sɵmɵgɾɵ/
ସମତଳ	/sɔmɔt̪ɔl̪ɔ/
ସମଯରେ	/sɔmɔd͡ʒɔre/
ସମୟ	/sɵmɵjɵ/
ସମୟର	/sɵmɵjɵɾɵ/
ସମୟରେ	/sɵmɵjɵre/
ସମୟେ	/sɔmɔje/
ସମର୍ଥକ	/sɔmɔrt̪ʰɔkɔ/
ସମର୍ଥନ	/sɵmɵrt̪ʰɵnɵ/
ସମସାମୟିକ	/sɔmɔsaːmɔjikɔ/
ସମସ୍ତ	/sɵmɵst̪ɵ/
ସମସ୍ତଂକୁ	/sɔmɔst̪ɔŋku/
ସମସ୍ତଙ୍କ	/sɵmɵst̪ɵŋkɵ/
ସମସ୍ତଙ୍କର	/sɔmɔst̪ɔŋkɔɾɔ/
ସମସ୍ତଙ୍କୁ	/sɵmɵst̪ɵŋku/
ସମସ୍ତେ	/sɵmɵst̪e/
ସମସ୍ଥାନିକ	/sɵmɵst̪ʰaːnikɵ/
ସମସ୍ୟା	/sɵmɵsjaː/
ସମାଜ	/sɵmaːd͡ʒɵ/
ସମାଧାନ	/sɵmaːd̪ʱaːnɵ/
ସମାନ	/sɵmaːnɵ/
ସମାପ୍ତ	/sɵmaːpt̪ɵ/
ସମିତି	/sɵmit̪i/
ସମିରା	/sɔmiraː/
ସମୀରା	/sɔmiraː/
ସମୀରାକୁ	/sɔmiraːku/
ସମୀରାର	/sɔmiraːɾɔ/
ସମୁଦାୟ	/sɵmud̪aːjɵ/
ସମୁଦ୍ର	/sɵmud̪ɾɵ/
ସମୁଦ୍ରରୁ	/sɔmud̪ɾɔru/
ସମୂହ	/sɵmuhɵ/
ସମୃଦ୍ଧ	/sɵmrud̪d̪ʱɵ/
ସମେତ	/sɵmet̪ɵ/
ସମ୍ପନ୍ନ	/sɵmpɵnnɵ/
ସମ୍ପର୍କ	/sɵmpɵrkɵ/
ସମ୍ପର୍କରେ	/sɵmpɵrkɵre/
ସମ୍ପାଦକ	/sɵmpaːd̪ɵkɵ/
ସମ୍ପାଦନ	/sɵmpaːd̪ɵnɵ/
ସମ୍ପାଦନା	/sɵmpaːd̪ɵnaː/
ସମ୍ପୁର୍ଣ୍ଣ	/sɵmpurɳɳɵ/
ସମ୍ପୂର୍ଣ୍ଣ	/sɵmpurɳɳɵ/
ସମ୍ପୃକ୍ତ	/sɔmprukt̪ɔ/
ସମ୍ବନ୍ଧରେ	/sɵmbɵnd̪ʱɵre/
ସମ୍ବନ୍ଧୀୟ	/sɵmbɵnd̪ʱijɵ/
ସମ୍ବଲପୁର	/sɵmbɵlɵpuɾɵ/
ସମ୍ବଲପୁରୀ	/sɵmbɵlɵpuri/
ସମ୍ବାଦ	/sɵmbaːd̪ɵ/
ସମ୍ବିଧାନ	/sɵmbid̪ʱaːnɵ/
ସମ୍ଭବ	/sɵmbʰɵbɵ/
ସମ୍ଭାବନା	/sɵmbʱaːbɵnaː/
ସମ୍ଭାଳି	/sɔmbʱaːl̪i/
ସମ୍ଭାଳୁ	/sɔmbʱaːl̪u/
ସମ୍ମାନ	/sɵmmaːnɵ/
ସମ୍ମାନିତ	/sɵmmaːnit̪ɵ/
ସମ୍ମିଶ୍ରଣ	/sɔmmisɾɔɳɔ/
ସମ୍ରାଟ	/sɵmraːʈɵ/
ସମ୍ରାଟଙ୍କ	/sɔmraːʈɔŋkɔ/
ସମ୍ରାଟଙ୍କର	/sɔmraːʈɔŋkɔɾɔ/
ସମ୍ରାଟଙ୍କୁ	/sɔmraːʈɔŋku/
ସମ୍ରାଟ୍	/sɔmraːʈ/
ସମ୍ୱାଦ	/sɔmuaːd̪ɔ/
ସଂଯୁକ୍ତ	/sɵŋd͡ʒukt̪ɵ/
ସଂଯୋଗ	/sɵŋd͡ʒoɡɵ/
ସର	/sɔɾɔ/
ସରକାର	/sɵɾɵkaːɾɵ/
ସରକାରଙ୍କ	/sɵɾɵkaːɾɵŋkɵ/
ସରକାରୀ	/sɵɾɵkaːri/
ସଂରକ୍ଷିତ	/sɵŋɾɵkʰit̪ɵ/
ସରବତ	/sɔɾɔbɔt̪ɔ/
ସରରେ	/sɔɾɔre/
ସରଳ	/sɵɾɵl̪ɵ/
ସରସ୍ଵତୀ	/sɵɾɵsuɵt̪i/
ସରି	/sɔri/
ସରିଆସିଲାଣି	/sɔriaːsilaːɳi/
ସରିଗଲା	/sɔriɡɔlaː/
ସରୁ	/sɔru/
ସର୍ବ	/sɵrbɵ/
ସର୍ବତ	/sɔrbɔt̪ɔ/
ସର୍ବତରୁ	/sɔrbɔt̪ɔru/
ସର୍ବଦା	/sɵrbɵd̪aː/
ସର୍ବାଧିକ	/sɵrbaːd̪ʱikɵ/
ସର୍ବୋଚ୍ଚ	/sɵrbot͡ʃt͡ʃɵ/
ସଂଳାପ	/sɵŋl̪aːpɵ/
ସଂଶୋଧନ	/sɵŋsod̪ʱɵnɵ/
ସଂସଦ	/sɵŋsɵd̪ɵ/
ସଂସାର	/sɵŋsaːɾɵ/
ସଂସ୍କରଣ	/sɵŋskɵɾɵɳɵ/
ସଂସ୍କୃତ	/sɵŋskrut̪ɵ/
ସଂସ୍କୃତରେ	/sɔŋskrut̪ɔre/
ସଂସ୍କୃତି	/sɵŋskrut̪i/
ସଂସ୍ଥା	/sɵŋst̪ʰaː/
ସଂସ୍ଥାନ	/sɵŋst̪ʰaːnɵ/
ସହ	/sɵhɵ/
ସହଜ	/sɵhɵd͡ʒɵ/
ସହଜକାମ	/sɔhɔd͡ʒɔkaːmɔ/
ସହଜରେ	/sɵhɵd͡ʒɵre/
ସହଯୋଗ	/sɵhɵd͡ʒoɡɵ/
ସହଯୋଗୀ	/sɔhɔd͡ʒogi/
ସହର	/sɵhɵɾɵ/
ସହରକୁ	/sɔhɔɾɔku/
ସହରଟିଏ	/sɔhɔɾɔʈie/
ସହରର	/sɵhɵɾɵɾɵ/
ସହରରେ	/sɵhɵɾɵre/
ସହସା	/sɔhɔsaː/
ସହସ୍ର	/sɔhɔsɾɔ/
ସହାୟକ	/sɵhaːjɵkɵ/
ସହାୟତା	/sɵhaːjɵt̪aː/
ସହିତ	/sɵhit̪ɵ/
ସାଇ	/saːi/
ସାଇକେଲ	/saːikelɔ/
ସାଏଁ	/saːẽ/
ସାକ୍ଷରତା	/saːkʰjɵɾɵt̪aː/
ସାଂଗ	/saːŋɡɔ/
ସାଂଗମାନଂକ	/saːŋɡɔmaːnɔŋkɔ/
ସାଗର	/saːɡɵɾɵ/
ସାଂଗରେ	/saːŋɡɔre/
ସାଂଗେ	/saːŋge/
ସାଙ୍କେତିକ	/saːŋket̪ikɔ/
ସାଙ୍ଗ	/saːŋɡɔ/
ସାଙ୍ଗମାନଙ୍କ	/saːŋɡɔmaːnɔŋkɔ/
ସାଙ୍ଗମାନଙ୍କୁ	/saːŋɡɔmaːnɔŋku/
ସାଙ୍ଗମାନେ	/saːŋɡɔmaːne/
ସାଙ୍ଗରେ	/saːŋɡɔre/
ସାଙ୍ଗସାଥୀ	/saːŋɡɔsaːt̪ʰi/
ସାଙ୍ଗେ	/saːŋge/
ସାଙ୍ଗେସାଙ୍ଗେ	/saːŋgesaːŋge/
ସାତ	/saːt̪ɵ/
ସାତଟା	/saːt̪ɔʈaː/
ସାଥିରେ	/saːt̪ʰire/
ସାଥୀମାନଙ୍କୁ	/saːt̪ʰimaːnɔŋku/
ସାଥୀରେ	/saːt̪ʰire/
ସାଥେ	/saːt̪ʰe/
ସାଧନ	/saːd̪ʱɵnɵ/
ସାଧନା	/saːd̪ʱɵnaː/
ସାଧାରଣ	/saːd̪ʱaːɾɵɳɵ/
ସାଧିବା	/saːd̪ʱibaː/
ସାଧୁ	/saːd̪ʱu/
ସାଧ୍ୟ	/saːd̪ʱjɔ/
ସାନ	/saːnɵ/
ସାନପିଲା	/saːnɔpilaː/
ସାନ୍ତ୍ୱନା	/saːnt̪uɔnaː/
ସାବଧାନ	/saːbɔd̪ʱaːnɔ/
ସାବଧାନତା	/saːbɔd̪ʱaːnɔt̪aː/
ସାବରମତି	/saːbɔɾɔmɔt̪i/
ସାବାସ୍	/saːbaːs/
ସାବିତ୍ରୀ	/saːbit̪ri/
ସାବୁନ	/saːbunɔ/
ସାମନାରଠିଆ	/saːmɔnaːɾɔʈʰiaː/
ସାମନାରେ	/saːmɔnaːre/
ସାମନ୍ତ	/saːmɵnt̪ɵ/
ସାମଲ	/saːmɵlɵ/
ସାମାଜିକ	/saːmaːd͡ʒikɵ/
ସାମାନ୍ୟ	/saːmaːnjɵ/
ସାମୁଏଲ	/saːmuelɵ/
ସାମୁଦ୍ରିକ	/saːmud̪rikɔ/
ସାମ୍ନାରେ	/saːmnaːre/
ସାମ୍ରାଜ୍ୟ	/saːmraːd͡ʒjɵ/
ସାର	/saːɾɵ/
ସାରକଥା	/saːɾɵkɵt̪ʰaː/
ସାରଣୀ	/saːɾɵɳi/
ସାରଳା	/saːɾɵl̪aː/
ସାରା	/saːraː/
ସାରି	/saːri/
ସାରିଥା	/saːrit̪ʰaː/
ସାରିଥିଲା	/saːrit̪ʰilaː/
ସାରିଲା	/saːrilaː/
ସାରିଲାଣି	/saːrilaːɳi/
ସାରେ	/saːre/
ସାର୍	/saːr/
ସାଂସଦ	/saːŋsɵd̪ɵ/
ସାସ୍ଥ୍ୟ	/saːst̪ʰjɔ/
ସାହସ	/saːhɔsɔ/
ସାହସୀ	/saːhɔsi/
ସାହାଜାନ	/saːhaːd͡ʒaːnɔ/
ସାହାଜାନଙ୍କ	/saːhaːd͡ʒaːnɔŋkɔ/
ସାହାଜାନାବାଦ	/saːhaːd͡ʒaːnaːbaːd̪ɔ/
ସାହାଯ୍ୟ	/saːhaːd͡ʒjɵ/
ସାହାଯ୍ୟରେ	/saːhaːd͡ʒjɵre/
ସାହିତ୍ୟ	/saːhit̪jɵ/
ସାହିତ୍ୟର	/saːhit̪jɵɾɵ/
ସାହିତ୍ୟରେ	/saːhit̪jɵre/
ସାହିତ୍ୟିକ	/saːhit̪jikɵ/
ସାହିଲ୍	/saːhil/
ସାହୀ-ପଡ଼ିଶାରେ	/saːhi-pɔɽisaːre/
ସାହୁ	/saːhu/
ସି	/si/
ସିଂ	/siŋ/
ସିଏ	/sie/
ସିକ୍ରି	/sikri/
ସିଂଗଡ଼ା	/siŋɡɔɽaː/
ସିଝା	/sid͡ʒʱaː/
ସିଝାଅ	/sid͡ʒʱaːɔ/
ସିଝିବ	/sid͡ʒʱibɔ/
ସିଝୁ	/sid͡ʒʱu/
ସିଝେଇବା	/sid͡ʒʱeibaː/
ସିଡ଼ି	/siɽi/
ସିଢ଼ି	/siɽʱi/
ସିଦ୍ଧ	/sid̪d̪ʱɵ/
ସିଦ୍ଧାନ୍ତ	/sid̪d̪ʱaːnt̪ɵ/
ସିଧା	/sid̪ʱaː/
ସିନା	/sinaː/
ସିନେ	/sine/
ସିନେମା	/sinemaː/
ସିନ୍ଦୁର	/sind̪uɾɔ/
ସିନ୍ଦୂର	/sind̪uɾɵ/
ସିମେଇ	/simei/
ସିମେଣ୍ଟ	/simeɳʈɔ/
ସିଂର	/siŋɾɔ/
ସିରିଞ	/siriɲɔ/
ସିଲକ୍	/silɔk/
ସିଲେଇ	/silei/
ସିଲେଇରେ	/sileire/
ସିଲ୍	/sil/
ସିଷ୍ଟମ	/sisʈɵmɵ/
ସିଂହ	/siŋhɵ/
ସିଂହକୁ	/siŋhɔku/
ସିଂହର	/siŋhɔɾɔ/
ସିଂହାସନ	/siŋhaːsɔnɔ/
ସୀଢ଼ୀରେ	/siɽʱire/
ସୀତା	/sit̪aː/
ସୀମା	/simaː/
ସୀଲଟ୍	/silɔʈ/
ସୁଁ	/sũ/
ସୁଆଦିଆ	/suaːd̪iaː/
ସୁକୁଟା	/sukuʈaː/
ସୁକ୍ଷ୍ମ	/sukʰmɔ/
ସୁଗନ୍ଧ	/suɡɔnd̪ʱɔ/
ସୁଜାତା	/sud͡ʒaːt̪aː/
ସୁଜି	/sud͡ʒi/
ସୁଦର୍ଶନ	/sud̪ɵrsɵnɵ/
ସୁଦ୍ଧା	/sud̪d̪ʱaː/
ସୁନା	/sunaː/
ସୁନାରଙ୍ଗର	/sunaːɾɔŋɡɔɾɔ/
ସୁନେଲି	/suneli/
ସୁନେଲୀ	/suneli/
ସୁନ୍ଦର	/sund̪ɵɾɵ/
ସୁନ୍ଦରଗଡ଼	/sund̪ɵɾɵɡɵɖɵ/
ସୁନ୍ଦରତା	/sund̪ɔɾɔt̪aː/
ସୁବର୍ଣ୍ଣପୁର	/subɵrɳɳɵpuɾɵ/
ସୁବାସ	/subaːsɵ/
ସୁବିଧା	/subid̪ʱaː/
ସୁବୁଠୁ	/subuʈʰu/
ସୁଭଦ୍ରା	/subʰɵd̪raː/
ସୁଭାସିସ	/subʱaːsisɵ/
ସୁଯୋଗ	/sud͡ʒoɡɵ/
ସୁରକ୍ଷା	/suɾɵkʰjaː/
ସୁରଥ	/suɾɵt̪ʰɵ/
ସୁରାଗଟିଏ	/suraːɡɔʈie/
ସୁରେନ୍ଦ୍ର	/surend̪ɾɵ/
ସୁଲତାନ୍	/sulɔt̪aːn/
ସୁଶାନ୍ତ	/susaːnt̪ɵ/
ସୁଶୀଳା	/susil̪aː/
ସୁଶୀଳାକୁ	/susil̪aːku/
ସୁଶୀଳାର	/susil̪aːɾɔ/
ସୁସାଦୁ	/susaːd̪u/
ସୁସ୍ଥ	/sust̪ʰɔ/
ସୂକ୍ଷ୍ମ	/sukʰmɔ/
ସୂକ୍ଷ୍ମରେଣୁ	/sukʰmɔreɳu/
ସୂଚନା	/sut͡ʃɵnaː/
ସୂତା	/sut̪aː/
ସୂତାକଟା	/sut̪aːkɔʈaː/
ସୂତାକାଟି	/sut̪aːkaːʈi/
ସୂତାକାମ	/sut̪aːkaːmɔ/
ସୂତାର	/sut̪aːɾɔ/
ସୂତାରେ	/sut̪aːre/
ସୂର୍ଯ୍ୟ	/surd͡ʒjɵ/
ସୂର୍ଯ଼୍ୟ	/surd͡ʒɔjɔ/
ସୂର୍ଯ୍ୟକୀରଣ	/surd͡ʒjɔkiɾɔɳɔ/
ସୂର୍ଯ୍ୟଙ୍କ	/surd͡ʒjɔŋkɔ/
ସୂର୍ଯ୍ୟଙ୍କର	/surd͡ʒjɔŋkɔɾɔ/
ସୃଷ୍ଟି	/sɵrusʈi/
ସେ	/se/
ସେଇ	/sei/
ସେଇଆ	/seiaː/
ସେଇକଥା	/seikɔt̪ʰaː/
ସେଇଟା	/seiʈaː/
ସେଇଟାକୁ	/seiʈaːku/
ସେଇଟି	/seiʈi/
ସେଇଠି	/seiʈʰi/
ସେଇୟା	/seijaː/
ସେଓ	/seo/
ସେକି	/seki/
ସେଗୁଡାକ	/seguɖaːkɔ/
ସେଗୁଡ଼ାକ	/seguɽaːkɔ/
ସେଗୁଡ଼ିକ	/seguɽikɔ/
ସେଗୁଡିକର	/seguɖikɔɾɔ/
ସେଟା	/seʈaː/
ସେଠାରୁ	/seʈʰaːru/
ସେଠାରେ	/seʈʰaːre/
ସେଠି	/seʈʰi/
ସେଠିବି	/seʈʰibi/
ସେଠୀ	/seʈʰi/
ସେଠୁ	/seʈʰu/
ସେତିକି	/set̪iki/
ସେତିକିବେଳେ	/set̪ikibel̪e/
ସେତେ	/set̪e/
ସେତେଟା	/set̪eʈaː/
ସେତେବେଳେ	/set̪ebel̪e/
ସେଥି	/set̪ʰi/
ସେଥିପାଇଁ	/set̪ʰipaːĩ/
ସେଥିରୁ	/set̪ʰiru/
ସେଥିରେ	/set̪ʰire/
ସେଦିନ	/sed̪inɔ/
ସେନା	/senaː/
ସେନାପତି	/senaːpɵt̪i/
ସେପଟ	/sepɔʈɔ/
ସେପଟକୁ	/sepɔʈɔku/
ସେପଟେମ୍ବର	/sepɵʈembɵɾɵ/
ସେପାଖରୁ	/sepaːkʰɔru/
ସେପ୍ଟେମ୍ବର	/sepʈembɵɾɵ/
ସେବକ	/sebɵkɵ/
ସେବନ	/sebɵnɵ/
ସେବା	/sebaː/
ସେବାଟେ	/sebaːʈe/
ସେମାନଙ୍କ	/semaːnɵŋkɵ/
ସେମାନଙ୍କର	/semaːnɵŋkɵɾɵ/
ସେମାନଙ୍କୁ	/semaːnɵŋku/
ସେମାନେ	/semaːne/
ସେମିତି	/semit̪i/
ସେହି	/sehi/
ସେହିପରି	/sehipɵri/
ସୈନିକ	/sɔinikɔ/
ସୈରା	/sɔiraː/
ସୋନପୁର	/sonɵpuɾɵ/
ସୋନୁ	/sonu/
ସୋଫାରେ	/sopʰaːre/
ସୋମାନେ	/somaːne/
ସୋରିଷ	/sorisɵ/
ସ୍	/s/
ସ୍କୁଟର	/skuʈɔɾɔ/
ସ୍କୁଲ	/skulɵ/
ସ୍କୁଲକୁ	/skulɔku/
ସ୍କୁଲଟିଏ	/skulɔʈie/
ସ୍କୁଲବ୍ୟାଗ	/skulɔbjaːɡɔ/
ସ୍କୁଲର	/skulɔɾɔ/
ସ୍କୁଲରୁ	/skulɔru/
ସ୍କୁଲରେ	/skulɵre/
ସ୍କୁଲ୍	/skul/
ସ୍ଟୋଭ୍	/sʈobʱ/
ସ୍ତମ୍ଭ	/st̪ɵmbʰɵ/
ସ୍ତର	/st̪ɵɾɵ/
ସ୍ତରରେ	/st̪ɵɾɵre/
ସ୍ତ୍ରୀ	/st̪ri/
ସ୍ତ୍ରୀଲୋକ	/st̪rilokɔ/
ସ୍ଥଳ	/st̪ʰɵl̪ɵ/
ସ୍ଥାନ	/st̪ʰaːnɵ/
ସ୍ଥାନରେ	/st̪ʰaːnɵre/
ସ୍ଥାନୀୟ	/st̪ʰaːnijɵ/
ସ୍ଥାପନ	/st̪ʰaːpɵnɵ/
ସ୍ଥାପନା	/st̪ʰaːpɵnaː/
ସ୍ଥାପିତ	/st̪ʰaːpit̪ɵ/
ସ୍ଥିତ	/st̪ʰit̪ɵ/
ସ୍ଥିତି	/st̪ʰit̪i/
ସ୍ଥିର	/st̪ʰiɾɵ/
ସ୍ନାତକ	/snaːt̪ɵkɵ/
ସ୍ନାତକୋତ୍ତର	/snaːt̪ɵkot̪t̪ɵɾɵ/
ସ୍ନାନ	/snaːnɵ/
ସ୍ନାୟୁ	/snaːju/
ସ୍ନିଫଲସ	/snipʰɔlɔsɔ/
ସ୍ନିଫଲ୍ସ	/snipʰɔlsɔ/
ସ୍ନିଫଲ୍ସକୁ	/snipʰɔlsɔku/
ସ୍ନିଫଲ୍ସର	/snipʰɔlsɔɾɔ/
ସ୍ପଷ୍ଟ	/spɔsʈɔ/
ସ୍ବାଦ	/sbaːd̪ɔ/
ସ୍ବାଦିଷ୍ଟ	/sbaːd̪isʈɔ/
ସ୍ମୃତି	/smrut̪i/
ସ୍ମୃତିର	/smrut̪iɾɔ/
ସ୍ଵତନ୍ତ୍ର	/suɵt̪ɵnt̪ɾɵ/
ସ୍ଵପ୍ନ	/suɔpnɔ/
ସ୍ଵପ୍ନକୁ	/suɔpnɔku/
ସ୍ଵପ୍ନଟେ	/suɔpnɔʈe/
ସ୍ଵର	/suɔɾɔ/
ସ୍ଵରୂପ	/suɵrupɵ/
ସ୍ଵର୍ଣ୍ଣ	/suɵrɳɳɵ/
ସ୍ଵଳ୍ପ	/suɵl̪pɵ/
ସ୍ଵାଇଁ	/suaːĩ/
ସ୍ଵାଗତମ୍	/suaːɡɔt̪ɔm/
ସ୍ଵାଧୀନ	/suaːd̪ʱinɵ/
ସ୍ଵାଧୀନତା	/suaːd̪ʱinɵt̪aː/
ସ୍ଵାମୀ	/suaːmi/
ସ୍ଵାସ୍ଥ୍ୟ	/suaːst̪ʰjɵ/
ସ୍ଵେଟର	/sueʈɔɾɔ/
ସ୍ୱତନ୍ତ୍ର	/suɵt̪ɵnt̪ɾɵ/
ସ୍ୱପ୍ନ	/suɔpnɔ/
ସ୍ୱରରେ	/suɔɾɔre/
ସ୍ୱରୁପ	/suɔrupɔ/
ସ୍ୱରୂପ	/suɵrupɵ/
ସ୍ୱର୍ଗ	/suɔrɡɔ/
ସ୍ୱାଗତ	/suaːɡɔt̪ɔ/
ସ୍ୱାଦ	/suaːd̪ɔ/
ସ୍ୱାଦର	/suaːd̪ɔɾɔ/
ସ୍ୱାଦିଷ୍ଟ	/suaːd̪isʈɔ/
ସ୍ୱାଧୀନତା	/suaːd̪ʱinɵt̪aː/
ସ୍ୱାଧୀନତାର	/suaːd̪ʱinɔt̪aːɾɔ/
ସ୍ୱିଚ	/suit͡ʃɔ/
ସ୍ୱେଚ୍ଚାସେବୀ	/suet͡ʃt͡ʃaːsebi/
ହଁ	/hɵ̃/
ହଅ	/hɔɔ/
ହଇରାଣ	/hɔiraːɳɔ/
ହଉ	/hɔu/
ହଉଛି	/hɔut͡ʃʰi/
ହକି	/hɵki/
ହଜାର	/hɵd͡ʒaːɾɵ/
ହଜିଗଲା	/hɔd͡ʒiɡɔlaː/
ହଜିଥିବା	/hɔd͡ʒit̪ʰibaː/
ହଜୁର	/hɔd͡ʒuɾɔ/
ହଜୁର୍	/hɔd͡ʒur/
ହଜେଇ	/hɔd͡ʒei/
ହଟାଗଲା	/hɵʈaːɡɵlaː/
ହଟାନ୍ତୁ	/hɵʈaːnt̪u/
ହଠାତ୍	/hɔʈʰaːt̪/
ହତାଶ	/hɔt̪aːsɔ/
ହନୁମାନ	/hɵnumaːnɵ/
ହପ୍	/hɔp/
ହବାକୁ	/hɔbaːku/
ହର	/hɵɾɵ/
ହରଣ	/hɔɾɔɳɔ/
ହରି	/hɔri/
ହରିଣ	/hɔriɳɔ/
ହରିହର	/hɵrihɵɾɵ/
ହରେକୃଷ୍ଣ	/hɵrekrusɳɵ/
ହଲନ୍ତି	/hɔlɔnt̪i/
ହଲାଅ	/hɔlaːɔ/
ହଲାଇ	/hɔlaːi/
ହଲାଇଲା	/hɔlaːilaː/
ହଲାଇଲେ	/hɔlaːile/
ହଲାଉ	/hɔlaːu/
ହଲି	/hɔli/
ହଲେ	/hɔle/
ହଲେଇବାକୁ	/hɔleibaːku/
ହଳଦିଆ	/hɵl̪ɵd̪iaː/
ହଳଦୀ	/hɵl̪ɵd̪i/
ହଂସ	/hɔŋsɔ/
ହସ	/hɔsɔ/
ହଂସଟିଏ	/hɔŋsɔʈie/
ହସଟିଏ	/hɔsɔʈie/
ହସନ୍ତି	/hɔsɔnt̪i/
ହସରେ	/hɔsɔre/
ହସାନ୍ତି	/hɔsaːnt̪i/
ହସି	/hɔsi/
ହସିଉଠୁଥିଲା	/hɔsiuʈʰut̪ʰilaː/
ହସିକି	/hɔsiki/
ହସିଦେଲା	/hɔsid̪elaː/
ହସିଦେଲେ	/hɔsid̪ele/
ହସିବାକୁ	/hɔsibaːku/
ହସିଲା	/hɔsilaː/
ହସିଲି	/hɔsili/
ହସିଲୁ	/hɔsilu/
ହସିଲେ	/hɔsile/
ହସିହସି	/hɔsihɔsi/
ହସୁ	/hɔsu/
ହସୁଛନ୍ତି	/hɔsut͡ʃʰɔnt̪i/
ହସୁଥିବା	/hɔsut̪ʰibaː/
ହସୁଥିଲା	/hɔsut̪ʰilaː/
ହସୁଥିଲେ	/hɔsut̪ʰile/
ହସେ-ଚିତ୍ର	/hɔse-t͡ʃit̪ɾɔ/
ହା	/haː/
ହାଃ	/haːh/
ହାଇ	/haːi/
ହାଇଁ	/haːĩ/
ହାଇଦ୍ରାବାଦ	/haːid̪raːbaːd̪ɵ/
ହାଇସ୍କୁଲ	/haːiskulɵ/
ହାଉ	/haːu/
ହାଏ	/haːe/
ହାଡ	/haːɖɔ/
ହାଡ଼	/haːɖɵ/
ହାଡ଼	/haːɽɔ/
ହାଡ଼ଟିକୁ	/haːɽɔʈiku/
ହାଣ୍ଡି	/haːɳɖi/
ହାଣ୍ଡିକୁ	/haːɳɖiku/
ହାଣ୍ଡିଟିକୁ	/haːɳɖiʈiku/
ହାତ	/haːt̪ɵ/
ହାତକୁ	/haːt̪ɔku/
ହାତରେ	/haːt̪ɵre/
ହାତୀ	/haːt̪i/
ହାତୀଠୁ	/haːt̪iʈʰu/
ହାର	/haːɾɵ/
ହାରାହାରି	/haːraːhaːri/
ହାରିନଥିଲେ	/haːrinɔt̪ʰile/
ହାଲକା	/haːlɔkaː/
ହାଲିଆ	/haːliaː/
ହାଲୁଆ	/haːluaː/
ହାସଲ	/haːsɵlɵ/
ହି	/hi/
ହିଁ	/hĩ/
ହିଃ	/hih/
ହିଁଠିକ୍	/hĩʈʰik/
ହିନ୍ଦୀ	/hind̪i/
ହିନ୍ଦୁ	/hind̪u/
ହିମାଚଳ	/himaːt͡ʃɵl̪ɵ/
ହିରନ୍	/hiɾɔn/
ହିସାବ	/hisaːbɵ/
ହିସାବରେ	/hisaːbɵre/
ହିସାବ୍	/hisaːb/
ହୁଁ	/hũ/
ହୁଅ	/huɔ/
ହୁଅନା	/huɔnaː/
ହୁଅନି	/huɔni/
ହୁଅନ୍ତା	/huɔnt̪aː/
ହୁଅନ୍ତି	/huɵnt̪i/
ହୁଅନ୍ତିନି	/huɔnt̪ini/
ହୁଇସିଲ	/huisilɔ/
ହୁଏ	/hue/
ହୁଏତ	/huet̪ɔ/
ହୁକୁମ	/hukumɔ/
ହୁରୁଡ଼େଇ	/huruɽei/
ହୃଦୟ	/hɔrud̪ɔjɔ/
ହୃଦୟର	/hɔrud̪ɔjɔɾɔ/
ହେ	/he/
ହେଃ	/heh/
ହେଇ	/hei/
ହେଇଗଲା	/heiɡɔlaː/
ହେଇଗଲି	/heiɡɔli/
ହେଇଛି	/heit͡ʃʰi/
ହେଇଥାଏ	/heit̪ʰaːe/
ହେଇଥିଲା	/heit̪ʰilaː/
ହେଇନି	/heini/
ହେଇପଡ଼ିଥାଏ	/heipɔɽit̪ʰaːe/
ହେଇପାରିବ	/heipaːribɔ/
ହେଇପାରେ	/heipaːre/
ହେଇଯାଆନ୍ତି	/heid͡ʒaːaːnt̪i/
ହେଇଯାଇଛି	/heid͡ʒaːit͡ʃʰi/
ହେଇଯିବ	/heid͡ʒibɔ/
ହେଇସାରିଥିଲା	/heisaːrit̪ʰilaː/
ହେଉ	/heu/
ହେଉଛନ୍ତି	/heut͡ʃʰɵnt̪i/
ହେଉଛି	/heut͡ʃʰi/
ହେଉଥିବା	/heut̪ʰibaː/
ହେଉଥିବାବେଳେ	/heut̪ʰibaːbel̪e/
ହେଉଥିଲା	/heut̪ʰilaː/
ହେଉଥିଲେ	/heut̪ʰile/
ହେଣ୍ଡା-ଏଗୁଡ଼ିକ	/heɳɖaː-eguɽikɔ/
ହେତୁ	/het̪u/
ହେବ	/hebɵ/
ହେବକି	/hebɔki/
ହେବନି	/hebɔni/
ହେବା	/hebaː/
ହେବାକୁ	/hebaːku/
ହେବାପରେ	/hebaːpɵre/
ହେବାର	/hebaːɾɵ/
ହେବାରୁ	/hebaːru/
ହେବାରେ	/hebaːre/
ହେବି	/hebi/
ହେବୁନି	/hebuni/
ହେବେ	/hebe/
ହେମନ୍ତ	/hemɵnt̪ɵ/
ହେଲା	/helaː/
ହେଲାଣି	/helaːɳi/
ହେଲାନି	/helaːni/
ହେଲାବେଳେ	/helaːbel̪e/
ହେଲି	/heli/
ହେଲୁ	/helu/
ହେଲେ	/hele/
ହେଲେଣି	/heleɳi/
ହେଲେବି	/helebi/
ହୈଦରାବାଦ	/hɔid̪ɔraːbaːd̪ɔ/
ହୋ	/ho/
ହୋଇ	/hoi/
ହୋଇଅଛି	/hoiɵt͡ʃʰi/
ହୋଇଉଠିଥିଲା	/hoiuʈʰit̪ʰilaː/
ହୋଇଉଠେ	/hoiuʈʰe/
ହୋଇଗଲା	/hoiɡɔlaː/
ହୋଇଗଲିଣି	/hoiɡɔliɳi/
ହୋଇଗଲେ	/hoiɡɵle/
ହୋଇଛ	/hoit͡ʃʰɔ/
ହୋଇଛନ୍ତି	/hoit͡ʃʰɵnt̪i/
ହୋଇଛି	/hoit͡ʃʰi/
ହୋଇଥାଏ	/hoit̪ʰaːe/
ହୋଇଥାନ୍ତା	/hoit̪ʰaːnt̪aː/
ହୋଇଥାନ୍ତି	/hoit̪ʰaːnt̪i/
ହୋଇଥିବା	/hoit̪ʰibaː/
ହୋଇଥିବାର	/hoit̪ʰibaːɾɔ/
ହୋଇଥିବାରୁ	/hoit̪ʰibaːru/
ହୋଇଥିଲା	/hoit̪ʰilaː/
ହୋଇଥିଲେ	/hoit̪ʰile/
ହୋଇନାହିଁ	/hoinaːhĩ/
ହୋଇପଡ଼ିଲା	/hoipɔɽilaː/
ହୋଇପଡ଼ିଲେ	/hoipɔɽile/
ହୋଇପାରେ	/hoipaːre/
ହୋଇଯାଇଛି	/hoid͡ʒaːit͡ʃʰi/
ହୋଇଯାଇଥିଲା	/hoid͡ʒaːit̪ʰilaː/
ହୋଇଯାଉଛି	/hoid͡ʒaːut͡ʃʰi/
ହୋଇଯାଉଥିଲା	/hoid͡ʒaːut̪ʰilaː/
ହୋଇଯାଏ	/hoid͡ʒaːe/
ହୋଇଯାନ୍ତି	/hoid͡ʒaːnt̪i/
ହୋଇଯିବ	/hoid͡ʒibɔ/
ହୋଇଯିବା	/hoid͡ʒibaː/
ହୋଇଯିବେ	/hoid͡ʒibe/
ହୋଇରହିଗଲେ	/hoiɾɔhiɡɔle/
ହୋଇସାରିଛି	/hoisaːrit͡ʃʰi/
ହୋମ୍-ୱର୍କ	/hom-uɔrkɔ/
ହୋଲି	/holi/
ହୋଲିକା	/holikaː/
ହ୍ୟାପୀ	/hjaːpi/
ହ୍ରଦ	/hɾɵd̪ɵ/
ହ୍ରାସ	/hraːsɵ/
